f_0,f_1,f_2,f_3,f_4,f_5,f_6,f_7,f_8,f_9,f_10,f_11,f_12,f_13,f_14,diff,diff2,std,target
2094,2095,2096,2096,2091,2088,2085,2083,2083,2088,2090,2095,2096,2095,2093,-1,10,4.768947173418589,0
2095,2096,2096,2091,2088,2085,2083,2083,2088,2090,2095,2096,2095,2093,2087,-8,4,4.817626366741593,0
2096,2096,2091,2088,2085,2083,2083,2088,2090,2095,2096,2095,2093,2087,2084,-12,-4,4.956957592256421,0
2096,2091,2088,2085,2083,2083,2088,2090,2095,2096,2095,2093,2087,2084,2077,-19,-13,5.687915343285355,0
2091,2088,2085,2083,2083,2088,2090,2095,2096,2095,2093,2087,2084,2077,2078,-13,-17,5.938574464184706,0
2088,2085,2083,2083,2088,2090,2095,2096,2095,2093,2087,2084,2077,2078,2080,-8,-16,6.155137227204142,0
2085,2083,2083,2088,2090,2095,2096,2095,2093,2087,2084,2077,2078,2080,2083,-2,-12,6.220549661825561,0
2083,2083,2088,2090,2095,2096,2095,2093,2087,2084,2077,2078,2080,2083,2086,3,-7,6.20905636569527,0
2083,2088,2090,2095,2096,2095,2093,2087,2084,2077,2078,2080,2083,2086,2086,3,-1,6.134989424448524,0
2088,2090,2095,2096,2095,2093,2087,2084,2077,2078,2080,2083,2086,2086,2081,-7,-3,6.2427100342262065,0
2090,2095,2096,2095,2093,2087,2084,2077,2078,2080,2083,2086,2086,2081,2078,-12,1,6.605913656572817,0
2095,2096,2095,2093,2087,2084,2077,2078,2080,2083,2086,2086,2081,2078,2076,-19,-2,6.969320524371696,0
2096,2095,2093,2087,2084,2077,2078,2080,2083,2086,2086,2081,2078,2076,2065,-31,-15,8.106434833777776,0
2095,2093,2087,2084,2077,2078,2080,2083,2086,2086,2081,2078,2076,2065,2060,-35,-23,9.233479455608425,0
2093,2087,2084,2077,2078,2080,2083,2086,2086,2081,2078,2076,2065,2060,2060,-33,-26,9.7428850718773,0
2087,2084,2077,2078,2080,2083,2086,2086,2081,2078,2076,2065,2060,2060,2064,-23,-22,9.484322904265804,0
2084,2077,2078,2080,2083,2086,2086,2081,2078,2076,2065,2060,2060,2064,2065,-19,-16,9.417814932097471,0
2077,2078,2080,2083,2086,2086,2081,2078,2076,2065,2060,2060,2064,2065,2069,-8,-9,9.171903266160712,0
2078,2080,2083,2086,2086,2081,2078,2076,2065,2060,2060,2064,2065,2069,2071,-7,-5,9.156314500829208,0
2080,2083,2086,2086,2081,2078,2076,2065,2060,2060,2064,2065,2069,2071,2067,-13,2,9.207657268868797,0
2083,2086,2086,2081,2078,2076,2065,2060,2060,2064,2065,2069,2071,2067,2062,-21,2,9.364573567185966,0
2086,2086,2081,2078,2076,2065,2060,2060,2064,2065,2069,2071,2067,2062,2053,-33,-7,9.927355184155594,0
2086,2081,2078,2076,2065,2060,2060,2064,2065,2069,2071,2067,2062,2053,2044,-42,-20,10.832930395436913,0
2081,2078,2076,2065,2060,2060,2064,2065,2069,2071,2067,2062,2053,2044,2040,-41,-25,11.480832888319723,0
2078,2076,2065,2060,2060,2064,2065,2069,2071,2067,2062,2053,2044,2040,2039,-39,-30,12.058587139856966,0
2076,2065,2060,2060,2064,2065,2069,2071,2067,2062,2053,2044,2040,2039,2045,-31,-26,11.714866419985132,0
2065,2060,2060,2064,2065,2069,2071,2067,2062,2053,2044,2040,2039,2045,2050,-15,-17,10.859272973998284,0
2060,2060,2064,2065,2069,2071,2067,2062,2053,2044,2040,2039,2045,2050,2054,-6,-8,10.644918304725769,0
2060,2064,2065,2069,2071,2067,2062,2053,2044,2040,2039,2045,2050,2054,2057,-3,4,10.596495377515827,0
2064,2065,2069,2071,2067,2062,2053,2044,2040,2039,2045,2050,2054,2057,2056,-8,12,10.538817137927134,0
2065,2069,2071,2067,2062,2053,2044,2040,2039,2045,2050,2054,2057,2056,2051,-14,11,10.343159690392119,0
2069,2071,2067,2062,2053,2044,2040,2039,2045,2050,2054,2057,2056,2051,2043,-26,4,10.363397126425292,0
2071,2067,2062,2053,2044,2040,2039,2045,2050,2054,2057,2056,2051,2043,2047,-24,2,9.520404153085899,0
2067,2062,2053,2044,2040,2039,2045,2050,2054,2057,2056,2051,2043,2047,2049,-18,-1,7.936053955269734,0
2062,2053,2044,2040,2039,2045,2050,2054,2057,2056,2051,2043,2047,2049,2050,-12,-4,6.488084316286133,0
2053,2044,2040,2039,2045,2050,2054,2057,2056,2051,2043,2047,2049,2050,2058,5,1,5.993647430722758,0
2044,2040,2039,2045,2050,2054,2057,2056,2051,2043,2047,2049,2050,2058,2069,25,13,7.872798256081022,0
2040,2039,2045,2050,2054,2057,2056,2051,2043,2047,2049,2050,2058,2069,2077,37,26,10.279429296739515,0
2039,2045,2050,2054,2057,2056,2051,2043,2047,2049,2050,2058,2069,2077,2083,44,40,12.376244526164978,0
2045,2050,2054,2057,2056,2051,2043,2047,2049,2050,2058,2069,2077,2083,2090,45,43,14.441013023429386,0
2050,2054,2057,2056,2051,2043,2047,2049,2050,2058,2069,2077,2083,2090,2090,40,41,16.003571030063437,0
2054,2057,2056,2051,2043,2047,2049,2050,2058,2069,2077,2083,2090,2090,2089,35,39,17.113904121670025,0
2057,2056,2051,2043,2047,2049,2050,2058,2069,2077,2083,2090,2090,2089,2088,31,30,17.89998669858511,0
2056,2051,2043,2047,2049,2050,2058,2069,2077,2083,2090,2090,2089,2088,2083,27,14,18.174550495522183,0
2051,2043,2047,2049,2050,2058,2069,2077,2083,2090,2090,2089,2088,2083,2086,35,9,18.385553334848844,0
2043,2047,2049,2050,2058,2069,2077,2083,2090,2090,2089,2088,2083,2086,2087,44,4,18.046764648704052,0
2047,2049,2050,2058,2069,2077,2083,2090,2090,2089,2088,2083,2086,2087,2089,42,-1,16.4996392456955,0
2049,2050,2058,2069,2077,2083,2090,2090,2089,2088,2083,2086,2087,2089,2095,46,5,15.141554301546016,0
2050,2058,2069,2077,2083,2090,2090,2089,2088,2083,2086,2087,2089,2095,2100,50,11,13.603921003397023,0
2058,2069,2077,2083,2090,2090,2089,2088,2083,2086,2087,2089,2095,2100,2100,42,12,11.011682108431158,0
2069,2077,2083,2090,2090,2089,2088,2083,2086,2087,2089,2095,2100,2100,2097,28,14,8.299741820425156,0
2077,2083,2090,2090,2089,2088,2083,2086,2087,2089,2095,2100,2100,2097,2093,16,7,6.43872214473826,0
2083,2090,2090,2089,2088,2083,2086,2087,2089,2095,2100,2100,2097,2093,2092,9,5,5.387816944604877,0
2090,2090,2089,2088,2083,2086,2087,2089,2095,2100,2100,2097,2093,2092,2090,0,1,4.949266419908923,0
2090,2089,2088,2083,2086,2087,2089,2095,2100,2100,2097,2093,2092,2090,2093,3,-2,4.955035918374453,0
2089,2088,2083,2086,2087,2089,2095,2100,2100,2097,2093,2092,2090,2093,2094,5,-6,4.97804704487135,0
2088,2083,2086,2087,2089,2095,2100,2100,2097,2093,2092,2090,2093,2094,2098,10,-2,5.163977794943222,0
2083,2086,2087,2089,2095,2100,2100,2097,2093,2092,2090,2093,2094,2098,2100,17,3,5.370111287310091,0
2086,2087,2089,2095,2100,2100,2097,2093,2092,2090,2093,2094,2098,2100,2101,15,8,4.937707198786941,0
2087,2089,2095,2100,2100,2097,2093,2092,2090,2093,2094,2098,2100,2101,2101,14,9,4.639375984311847,0
2089,2095,2100,2100,2097,2093,2092,2090,2093,2094,2098,2100,2101,2101,2097,8,7,4.035556254807296,0
2095,2100,2100,2097,2093,2092,2090,2093,2094,2098,2100,2101,2101,2097,2094,-1,1,3.5989416433697494,0
2100,2100,2097,2093,2092,2090,2093,2094,2098,2100,2101,2101,2097,2094,2091,-9,-3,3.8446004188930196,0
2100,2097,2093,2092,2090,2093,2094,2098,2100,2101,2101,2097,2094,2091,2086,-14,-12,4.470005859163093,0
2097,2093,2092,2090,2093,2094,2098,2100,2101,2101,2097,2094,2091,2086,2082,-15,-18,5.391351098441528,0
2093,2092,2090,2093,2094,2098,2100,2101,2101,2097,2094,2091,2086,2082,2081,-12,-20,6.2549028388784365,0
2092,2090,2093,2094,2098,2100,2101,2101,2097,2094,2091,2086,2082,2081,2084,-8,-17,6.659758325373447,0
2090,2093,2094,2098,2100,2101,2101,2097,2094,2091,2086,2082,2081,2084,2084,-6,-13,6.9945557059622825,0
2093,2094,2098,2100,2101,2101,2097,2094,2091,2086,2082,2081,2084,2084,2082,-11,-12,7.4277472070223665,0
2094,2098,2100,2101,2101,2097,2094,2091,2086,2082,2081,2084,2084,2082,2077,-17,-14,8.253714892326336,0
2098,2100,2101,2101,2097,2094,2091,2086,2082,2081,2084,2084,2082,2077,2069,-29,-17,9.796986903173464,0
2100,2101,2101,2097,2094,2091,2086,2082,2081,2084,2084,2082,2077,2069,2059,-41,-23,12.011105971835677,0
2101,2101,2097,2094,2091,2086,2082,2081,2084,2084,2082,2077,2069,2059,2046,-55,-35,15.153814544136907,0
2101,2097,2094,2091,2086,2082,2081,2084,2084,2082,2077,2069,2059,2046,2034,-67,-50,18.69759342803239,0
2097,2094,2091,2086,2082,2081,2084,2084,2082,2077,2069,2059,2046,2034,2033,-64,-51,20.796519855380566,0
2094,2091,2086,2082,2081,2084,2084,2082,2077,2069,2059,2046,2034,2033,2035,-59,-47,21.87584011992182,0
2091,2086,2082,2081,2084,2084,2082,2077,2069,2059,2046,2034,2033,2035,2042,-49,-35,21.773728162518196,0
2086,2082,2081,2084,2084,2082,2077,2069,2059,2046,2034,2033,2035,2042,2050,-36,-19,20.923215631947027,0
2082,2081,2084,2084,2082,2077,2069,2059,2046,2034,2033,2035,2042,2050,2053,-29,-6,20.04091053914705,0
2081,2084,2084,2082,2077,2069,2059,2046,2034,2033,2035,2042,2050,2053,2053,-28,7,19.224983745116667,0
2084,2084,2082,2077,2069,2059,2046,2034,2033,2035,2042,2050,2053,2053,2049,-35,15,18.34069116421059,0
2084,2082,2077,2069,2059,2046,2034,2033,2035,2042,2050,2053,2053,2049,2042,-42,9,17.028827099390973,0
2082,2077,2069,2059,2046,2034,2033,2035,2042,2050,2053,2053,2049,2042,2033,-49,-2,15.615316046692595,0
2077,2069,2059,2046,2034,2033,2035,2042,2050,2053,2053,2049,2042,2033,2029,-48,-13,13.869116084032932,0
2069,2059,2046,2034,2033,2035,2042,2050,2053,2053,2049,2042,2033,2029,2025,-44,-25,12.217473825086211,0
2059,2046,2034,2033,2035,2042,2050,2053,2053,2049,2042,2033,2029,2025,2033,-26,-20,10.215301314811079,0
2046,2034,2033,2035,2042,2050,2053,2053,2049,2042,2033,2029,2025,2033,2040,-6,-13,8.929885617568523,0
2034,2033,2035,2042,2050,2053,2053,2049,2042,2033,2029,2025,2033,2040,2049,15,0,9.1104335791443,0
2033,2035,2042,2050,2053,2053,2049,2042,2033,2029,2025,2033,2040,2049,2053,20,11,9.527903881806973,0
2035,2042,2050,2053,2053,2049,2042,2033,2029,2025,2033,2040,2049,2053,2053,18,20,9.68651492687496,0
2042,2050,2053,2053,2049,2042,2033,2029,2025,2033,2040,2049,2053,2053,2049,7,20,9.575763055508324,0
2050,2053,2053,2049,2042,2033,2029,2025,2033,2040,2049,2053,2053,2049,2040,-10,15,9.612491872558333,0
2053,2053,2049,2042,2033,2029,2025,2033,2040,2049,2053,2053,2049,2040,2035,-18,2,9.656973793955478,0
2053,2049,2042,2033,2029,2025,2033,2040,2049,2053,2053,2049,2040,2035,2030,-23,-10,9.6796300598338,0
2049,2042,2033,2029,2025,2033,2040,2049,2053,2053,2049,2040,2035,2030,2030,-19,-19,9.439027391380856,0
2042,2033,2029,2025,2033,2040,2049,2053,2053,2049,2040,2035,2030,2030,2033,-9,-20,9.168787633415155,0
2033,2029,2025,2033,2040,2049,2053,2053,2049,2040,2035,2030,2030,2033,2040,7,-13,9.125057077447059,0
2029,2025,2033,2040,2049,2053,2053,2049,2040,2035,2030,2030,2033,2040,2047,18,-2,9.277212224944876,0
2025,2033,2040,2049,2053,2053,2049,2040,2035,2030,2030,2033,2040,2047,2056,31,16,9.78969331685601,0
2033,2040,2049,2053,2053,2049,2040,2035,2030,2030,2033,2040,2047,2056,2055,22,20,9.37219799396573,0
2040,2049,2053,2053,2049,2040,2035,2030,2030,2033,2040,2047,2056,2055,2050,10,20,9.118270512704541,0
2049,2053,2053,2049,2040,2035,2030,2030,2033,2040,2047,2056,2055,2050,2045,-4,15,9.0527554342521,0
2053,2053,2049,2040,2035,2030,2030,2033,2040,2047,2056,2055,2050,2045,2038,-15,5,9.093168550385188,0
2053,2049,2040,2035,2030,2030,2033,2040,2047,2056,2055,2050,2045,2038,2031,-22,-9,9.241727317418741,0
2049,2040,2035,2030,2030,2033,2040,2047,2056,2055,2050,2045,2038,2031,2029,-20,-18,9.303353210127032,0
2040,2035,2030,2030,2033,2040,2047,2056,2055,2050,2045,2038,2031,2029,2034,-6,-22,9.132881462579256,0
2035,2030,2030,2033,2040,2047,2056,2055,2050,2045,2038,2031,2029,2034,2043,8,-12,9.176574731866124,0
2030,2030,2033,2040,2047,2056,2055,2050,2045,2038,2031,2029,2034,2043,2050,20,0,9.437513796899408,0
2030,2033,2040,2047,2056,2055,2050,2045,2038,2031,2029,2034,2043,2050,2055,25,10,9.612491872558333,0
2033,2040,2047,2056,2055,2050,2045,2038,2031,2029,2034,2043,2050,2055,2060,27,22,9.962787905859628,0
2040,2047,2056,2055,2050,2045,2038,2031,2029,2034,2043,2050,2055,2060,2055,15,24,9.782394292566524,0
2047,2056,2055,2050,2045,2038,2031,2029,2034,2043,2050,2055,2060,2055,2049,2,20,9.672247978230343,0
2056,2055,2050,2045,2038,2031,2029,2034,2043,2050,2055,2060,2055,2049,2042,-14,8,9.73848526404878,0
2055,2050,2045,2038,2031,2029,2034,2043,2050,2055,2060,2055,2049,2042,2039,-16,-4,9.494359227607577,0
2050,2045,2038,2031,2029,2034,2043,2050,2055,2060,2055,2049,2042,2039,2038,-12,-12,9.226256528181379,0
2045,2038,2031,2029,2034,2043,2050,2055,2060,2055,2049,2042,2039,2038,2042,-3,-13,9.076395340714967,0
2038,2031,2029,2034,2043,2050,2055,2060,2055,2049,2042,2039,2038,2042,2054,16,-6,9.482816539605178,0
2031,2029,2034,2043,2050,2055,2060,2055,2049,2042,2039,2038,2042,2054,2060,29,5,10.175601070347497,0
2029,2034,2043,2050,2055,2060,2055,2049,2042,2039,2038,2042,2054,2060,2065,36,16,10.519822558706334,0
2034,2043,2050,2055,2060,2055,2049,2042,2039,2038,2042,2054,2060,2065,2067,33,25,10.276186062932103,0
2043,2050,2055,2060,2055,2049,2042,2039,2038,2042,2054,2060,2065,2067,2065,22,26,9.895645988201554,0
2050,2055,2060,2055,2049,2042,2039,2038,2042,2054,2060,2065,2067,2065,2059,9,21,9.68553167407571,0
2055,2060,2055,2049,2042,2039,2038,2042,2054,2060,2065,2067,2065,2059,2055,0,13,9.64858736267844,0
2060,2055,2049,2042,2039,2038,2042,2054,2060,2065,2067,2065,2059,2055,2052,-8,-2,9.65006785073605,0
2055,2049,2042,2039,2038,2042,2054,2060,2065,2067,2065,2059,2055,2052,2049,-6,-11,9.535397711884363,0
2049,2042,2039,2038,2042,2054,2060,2065,2067,2065,2059,2055,2052,2049,2050,1,-15,9.537894346837177,0
2042,2039,2038,2042,2054,2060,2065,2067,2065,2059,2055,2052,2049,2050,2059,17,-8,9.63228697563317,0
2039,2038,2042,2054,2060,2065,2067,2065,2059,2055,2052,2049,2050,2059,2065,26,0,9.575265755357096,0
2038,2042,2054,2060,2065,2067,2065,2059,2055,2052,2049,2050,2059,2065,2072,34,13,9.525904531479263,0
2042,2054,2060,2065,2067,2065,2059,2055,2052,2049,2050,2059,2065,2072,2074,32,19,8.969790569302209,0
2054,2060,2065,2067,2065,2059,2055,2052,2049,2050,2059,2065,2072,2074,2073,19,21,8.267549876014112,0
2060,2065,2067,2065,2059,2055,2052,2049,2050,2059,2065,2072,2074,2073,2068,8,19,8.178368681204969,0
2065,2067,2065,2059,2055,2052,2049,2050,2059,2065,2072,2074,2073,2068,2064,-1,14,8.166715257387029,0
2067,2065,2059,2055,2052,2049,2050,2059,2065,2072,2074,2073,2068,2064,2059,-8,0,8.180697373929043,0
2065,2059,2055,2052,2049,2050,2059,2065,2072,2074,2073,2068,2064,2059,2058,-7,-7,8.122866020128141,0
2059,2055,2052,2049,2050,2059,2065,2072,2074,2073,2068,2064,2059,2058,2058,-1,-14,8.106434833777776,0
2055,2052,2049,2050,2059,2065,2072,2074,2073,2068,2064,2059,2058,2058,2067,12,-7,8.22771159528809,0
2052,2049,2050,2059,2065,2072,2074,2073,2068,2064,2059,2058,2058,2067,2075,23,2,8.700301034748056,0
2049,2050,2059,2065,2072,2074,2073,2068,2064,2059,2058,2058,2067,2075,2077,28,9,8.862978108535582,0
2050,2059,2065,2072,2074,2073,2068,2064,2059,2058,2058,2067,2075,2077,2083,33,19,8.953849930137793,0
2059,2065,2072,2074,2073,2068,2064,2059,2058,2058,2067,2075,2077,2083,2080,21,21,8.25659909232782,0
2065,2072,2074,2073,2068,2064,2059,2058,2058,2067,2075,2077,2083,2080,2076,11,18,7.977348885318683,0
2072,2074,2073,2068,2064,2059,2058,2058,2067,2075,2077,2083,2080,2076,2073,1,15,7.890923055426828,0
2074,2073,2068,2064,2059,2058,2058,2067,2075,2077,2083,2080,2076,2073,2066,-8,-1,7.959420893028647,0
2073,2068,2064,2059,2058,2058,2067,2075,2077,2083,2080,2076,2073,2066,2063,-10,-12,8.077010290825141,0
2068,2064,2059,2058,2058,2067,2075,2077,2083,2080,2076,2073,2066,2063,2069,1,-8,8.01308453777469,0
2064,2059,2058,2058,2067,2075,2077,2083,2080,2076,2073,2066,2063,2069,2074,10,-9,8.10525990300361,0
2059,2058,2058,2067,2075,2077,2083,2080,2076,2073,2066,2063,2069,2074,2081,22,1,8.466741656960739,0
2058,2058,2067,2075,2077,2083,2080,2076,2073,2066,2063,2069,2074,2081,2088,30,12,8.927218945183213,0
2058,2067,2075,2077,2083,2080,2076,2073,2066,2063,2069,2074,2081,2088,2093,35,20,9.417814932097471,0
2067,2075,2077,2083,2080,2076,2073,2066,2063,2069,2074,2081,2088,2093,2093,26,27,9.27515883575971,0
2075,2077,2083,2080,2076,2073,2066,2063,2069,2074,2081,2088,2093,2093,2091,16,28,9.458178622607148,0
2077,2083,2080,2076,2073,2066,2063,2069,2074,2081,2088,2093,2093,2091,2090,13,21,9.813984191666792,1
2083,2080,2076,2073,2066,2063,2069,2074,2081,2088,2093,2093,2091,2090,2088,5,14,9.999047573691826,1
2080,2076,2073,2066,2063,2069,2074,2081,2088,2093,2093,2091,2090,2088,2088,8,7,10.169047340312847,1
2076,2073,2066,2063,2069,2074,2081,2088,2093,2093,2091,2090,2088,2088,2091,15,3,10.493535424931185,1
2073,2066,2063,2069,2074,2081,2088,2093,2093,2091,2090,2088,2088,2091,2095,22,2,10.90783903350945,1
2066,2063,2069,2074,2081,2088,2093,2093,2091,2090,2088,2088,2091,2095,2103,37,10,11.691673879100378,1
2063,2069,2074,2081,2088,2093,2093,2091,2090,2088,2088,2091,2095,2103,2110,47,19,12.131423188209558,1
2069,2074,2081,2088,2093,2093,2091,2090,2088,2088,2091,2095,2103,2110,2117,48,27,12.257942031888668,1
2074,2081,2088,2093,2093,2091,2090,2088,2088,2091,2095,2103,2110,2117,2116,42,28,12.129460397058459,1
2081,2088,2093,2093,2091,2090,2088,2088,2091,2095,2103,2110,2117,2116,2114,33,26,11.681487185163663,1
2088,2093,2093,2091,2090,2088,2088,2091,2095,2103,2110,2117,2116,2114,2114,26,23,11.51892852159932,1
2093,2093,2091,2090,2088,2088,2091,2095,2103,2110,2117,2116,2114,2114,2116,23,21,11.804760944313145,1
2093,2091,2090,2088,2088,2091,2095,2103,2110,2117,2116,2114,2114,2116,2114,21,11,11.998015708957084,1
2091,2090,2088,2088,2091,2095,2103,2110,2117,2116,2114,2114,2116,2114,2106,15,-4,11.716085808266627,1
2090,2088,2088,2091,2095,2103,2110,2117,2116,2114,2114,2116,2114,2106,2112,22,-5,11.360751148875089,1
2088,2088,2091,2095,2103,2110,2117,2116,2114,2114,2116,2114,2106,2112,2107,19,-9,10.586154479633606,1
2088,2091,2095,2103,2110,2117,2116,2114,2114,2116,2114,2106,2112,2107,2103,15,-11,9.399594722772942,1
2091,2095,2103,2110,2117,2116,2114,2114,2116,2114,2106,2112,2107,2103,2095,4,-19,8.517768543015299,1
2095,2103,2110,2117,2116,2114,2114,2116,2114,2106,2112,2107,2103,2095,2039,-56,-77,19.381385276550674,1
2103,2110,2117,2116,2114,2114,2116,2114,2106,2112,2107,2103,2095,2039,2105,2,-9,19.218542633414764,1
2110,2117,2116,2114,2114,2116,2114,2106,2112,2107,2103,2095,2039,2105,2051,-59,-55,23.716982061283392,1
2117,2116,2114,2114,2116,2114,2106,2112,2107,2103,2095,2039,2105,2051,2205,88,93,35.81460197022597,1
2116,2114,2114,2116,2114,2106,2112,2107,2103,2095,2039,2105,2051,2205,2179,63,72,40.27666227245654,1
2114,2114,2116,2114,2106,2112,2107,2103,2095,2039,2105,2051,2205,2179,2182,68,79,44.190927748103405,1
2114,2116,2114,2106,2112,2107,2103,2095,2039,2105,2051,2205,2179,2182,2196,82,101,48.74540271363327,1
2116,2114,2106,2112,2107,2103,2095,2039,2105,2051,2205,2179,2182,2196,2210,94,171,53.72416322555163,1
2114,2106,2112,2107,2103,2095,2039,2105,2051,2205,2179,2182,2196,2210,2157,43,52,54.11161304809409,1
2106,2112,2107,2103,2095,2039,2105,2051,2205,2179,2182,2196,2210,2157,2185,79,134,55.627417015438745,1
2112,2107,2103,2095,2039,2105,2051,2205,2179,2182,2196,2210,2157,2185,2182,70,-23,56.2098957564625,1
2107,2103,2095,2039,2105,2051,2205,2179,2182,2196,2210,2157,2185,2182,2188,81,9,56.87555337250418,1
2103,2095,2039,2105,2051,2205,2179,2182,2196,2210,2157,2185,2182,2188,2178,75,-4,56.3859996132103,0
2095,2039,2105,2051,2205,2179,2182,2196,2210,2157,2185,2182,2188,2178,2169,74,-27,54.98631864468868,0
2039,2105,2051,2205,2179,2182,2196,2210,2157,2185,2182,2188,2178,2169,2154,115,-56,52.46041591614804,0
2105,2051,2205,2179,2182,2196,2210,2157,2185,2182,2188,2178,2169,2154,2189,84,32,41.082959043982264,0
2051,2205,2179,2182,2196,2210,2157,2185,2182,2188,2178,2169,2154,2189,2181,130,-4,37.17039272375388,0
2205,2179,2182,2196,2210,2157,2185,2182,2188,2178,2169,2154,2189,2181,2183,-22,1,15.127395520647143,0
2179,2182,2196,2210,2157,2185,2182,2188,2178,2169,2154,2189,2181,2183,2176,-3,-12,13.850219183412637,0
2182,2196,2210,2157,2185,2182,2188,2178,2169,2154,2189,2181,2183,2176,2186,4,8,13.910256579058421,0
2196,2210,2157,2185,2182,2188,2178,2169,2154,2189,2181,2183,2176,2186,2199,3,30,14.663852543877118,0
2210,2157,2185,2182,2188,2178,2169,2154,2189,2181,2183,2176,2186,2199,2177,-33,23,14.199932930760456,0
2157,2185,2182,2188,2178,2169,2154,2189,2181,2183,2176,2186,2199,2177,2185,28,-4,11.81081022179419,0
2185,2182,2188,2178,2169,2154,2189,2181,2183,2176,2186,2199,2177,2185,2178,-7,-3,10.104218826571309,0
2182,2188,2178,2169,2154,2189,2181,2183,2176,2186,2199,2177,2185,2178,2162,-20,-21,11.096116866895803,0
2188,2178,2169,2154,2189,2181,2183,2176,2186,2199,2177,2185,2178,2162,2166,-22,-10,11.560194429078399,0
2178,2169,2154,2189,2181,2183,2176,2186,2199,2177,2185,2178,2162,2166,2162,-16,-24,11.90838040245288,0
2169,2154,2189,2181,2183,2176,2186,2199,2177,2185,2178,2162,2166,2162,2180,11,-19,11.939530181392438,0
2154,2189,2181,2183,2176,2186,2199,2177,2185,2178,2162,2166,2162,2180,2175,21,-2,11.770827538978768,0
2189,2181,2183,2176,2186,2199,2177,2185,2178,2162,2166,2162,2180,2175,2183,-6,-2,9.99428408069904,0
2181,2183,2176,2186,2199,2177,2185,2178,2162,2166,2162,2180,2175,2183,2182,1,4,9.641181512261916,0
2183,2176,2186,2199,2177,2185,2178,2162,2166,2162,2180,2175,2183,2182,2180,-3,18,9.624868582899989,0
2176,2186,2199,2177,2185,2178,2162,2166,2162,2180,2175,2183,2182,2180,2182,6,16,9.593152319679461,0
2186,2199,2177,2185,2178,2162,2166,2162,2180,2175,2183,2182,2180,2182,2170,-16,8,9.813984191666792,0
2199,2177,2185,2178,2162,2166,2162,2180,2175,2183,2182,2180,2182,2170,2165,-34,-15,10.055559940365614,0
2177,2185,2178,2162,2166,2162,2180,2175,2183,2182,2180,2182,2170,2165,2169,-8,-6,8.016055317744685,0
2185,2178,2162,2166,2162,2180,2175,2183,2182,2180,2182,2170,2165,2169,2165,-20,-18,8.330666239863412,0
2178,2162,2166,2162,2180,2175,2183,2182,2180,2182,2170,2165,2169,2165,2167,-11,-15,7.854025355555856,0
2162,2166,2162,2180,2175,2183,2182,2180,2182,2170,2165,2169,2165,2167,2165,3,-15,7.909006318898788,0
2166,2162,2180,2175,2183,2182,2180,2182,2170,2165,2169,2165,2167,2165,2173,7,-9,7.4590948001815365,0
2162,2180,2175,2183,2182,2180,2182,2170,2165,2169,2165,2167,2165,2173,2191,29,21,8.65585406091216,0
2180,2175,2183,2182,2180,2182,2170,2165,2169,2165,2167,2165,2173,2191,2195,15,30,9.553358920644962,0
2175,2183,2182,2180,2182,2170,2165,2169,2165,2167,2165,2173,2191,2195,2176,1,7,9.493356072738951,0
2183,2182,2180,2182,2170,2165,2169,2165,2167,2165,2173,2191,2195,2176,2189,6,24,10.072593650949235,0
2182,2180,2182,2170,2165,2169,2165,2167,2165,2173,2191,2195,2176,2189,2167,-15,0,10.215301314811079,0
2180,2182,2170,2165,2169,2165,2167,2165,2173,2191,2195,2176,2189,2167,2165,-15,0,10.411532067856296,0
2182,2170,2165,2169,2165,2167,2165,2173,2191,2195,2176,2189,2167,2165,2167,-15,-6,10.470821134853523,0
2170,2165,2169,2165,2167,2165,2173,2191,2195,2176,2189,2167,2165,2167,2181,11,-10,10.417476159022852,0
2165,2169,2165,2167,2165,2173,2191,2195,2176,2189,2167,2165,2167,2181,2183,18,-12,10.629249850339976,0
2169,2165,2167,2165,2173,2191,2195,2176,2189,2167,2165,2167,2181,2183,2187,18,11,10.737118528064887,0
2165,2167,2165,2173,2191,2195,2176,2189,2167,2165,2167,2181,2183,2187,2183,18,-6,10.693567269736556,0
2167,2165,2173,2191,2195,2176,2189,2167,2165,2167,2181,2183,2187,2183,2185,18,18,10.340396971287394,0
2165,2173,2191,2195,2176,2189,2167,2165,2167,2181,2183,2187,2183,2185,2182,17,17,9.88842517193473,0
2173,2191,2195,2176,2189,2167,2165,2167,2181,2183,2187,2183,2185,2182,2176,3,9,9.133924207511875,0
2191,2195,2176,2189,2167,2165,2167,2181,2183,2187,2183,2185,2182,2176,2182,-9,1,8.93468362218671,0
2195,2176,2189,2167,2165,2167,2181,2183,2187,2183,2185,2182,2176,2182,2176,-19,-7,8.517209469236807,0
2176,2189,2167,2165,2167,2181,2183,2187,2183,2185,2182,2176,2182,2176,2197,21,10,8.786895003897783,0
2189,2167,2165,2167,2181,2183,2187,2183,2185,2182,2176,2182,2176,2197,2182,-7,-1,8.741254132532918,0
2167,2165,2167,2181,2183,2187,2183,2185,2182,2176,2182,2176,2197,2182,2190,23,5,8.817191000701818,0
2165,2167,2181,2183,2187,2183,2185,2182,2176,2182,2176,2197,2182,2190,2198,33,16,9.129752513205435,0
2167,2181,2183,2187,2183,2185,2182,2176,2182,2176,2197,2182,2190,2198,2171,4,-5,8.423323628614833,0
2181,2183,2187,2183,2185,2182,2176,2182,2176,2197,2182,2190,2198,2171,2181,0,-1,7.258492562902734,0
2183,2187,2183,2185,2182,2176,2182,2176,2197,2182,2190,2198,2171,2181,2176,-7,0,7.497301101698118,0
2187,2183,2185,2182,2176,2182,2176,2197,2182,2190,2198,2171,2181,2176,2168,-19,-29,8.47236403732467,0
2183,2185,2182,2176,2182,2176,2197,2182,2190,2198,2171,2181,2176,2168,2192,9,10,8.765190895158613,0
2185,2182,2176,2182,2176,2197,2182,2190,2198,2171,2181,2176,2168,2192,2162,-23,-28,10.248344814094198,0
2182,2176,2182,2176,2197,2182,2190,2198,2171,2181,2176,2168,2192,2162,2192,10,-6,10.58750386518173,0
2176,2182,2176,2197,2182,2190,2198,2171,2181,2176,2168,2192,2162,2192,2190,14,19,10.80476085542189,0
2182,2176,2197,2182,2190,2198,2171,2181,2176,2168,2192,2162,2192,2190,2178,-4,-3,10.734900802433865,0
2176,2197,2182,2190,2198,2171,2181,2176,2168,2192,2162,2192,2190,2178,2189,13,13,10.870668267012316,0
2197,2182,2190,2198,2171,2181,2176,2168,2192,2162,2192,2190,2178,2189,2196,-1,28,11.198639373134748,0
2182,2190,2198,2171,2181,2176,2168,2192,2162,2192,2190,2178,2189,2196,2179,-3,-13,10.673509709735104,0
2190,2198,2171,2181,2176,2168,2192,2162,2192,2190,2178,2189,2196,2179,2175,-15,13,10.868477792396208,0
2198,2171,2181,2176,2168,2192,2162,2192,2190,2178,2189,2196,2179,2175,2174,-24,-18,10.861465304986643,0
2171,2181,2176,2168,2192,2162,2192,2190,2178,2189,2196,2179,2175,2174,2171,0,-19,10.126344707882364,0
2181,2176,2168,2192,2162,2192,2190,2178,2189,2196,2179,2175,2174,2171,2171,-10,-7,10.126344707882364,0
2176,2168,2192,2162,2192,2190,2178,2189,2196,2179,2175,2174,2171,2171,2157,-19,-32,11.66802713156158,0
2168,2192,2162,2192,2190,2178,2189,2196,2179,2175,2174,2171,2171,2157,2189,21,-7,11.987294861445516,0
2192,2162,2192,2190,2178,2189,2196,2179,2175,2174,2171,2171,2157,2189,2190,-2,11,11.90838040245288,0
2162,2192,2190,2178,2189,2196,2179,2175,2174,2171,2171,2157,2189,2190,2179,17,4,11.463399313010248,0
2192,2190,2178,2189,2196,2179,2175,2174,2171,2171,2157,2189,2190,2179,2183,-9,9,10.411989426114676,0
2190,2178,2189,2196,2179,2175,2174,2171,2171,2157,2189,2190,2179,2183,2200,10,29,11.198214143335536,0
2178,2189,2196,2179,2175,2174,2171,2171,2157,2189,2190,2179,2183,2200,2193,15,22,11.387963570617632,0
2189,2196,2179,2175,2174,2171,2171,2157,2189,2190,2179,2183,2200,2193,2171,-18,14,11.685562928347995,0
2196,2179,2175,2174,2171,2171,2157,2189,2190,2179,2183,2200,2193,2171,2182,-14,-7,11.48705275309472,0
2179,2175,2174,2171,2171,2157,2189,2190,2179,2183,2200,2193,2171,2182,2175,-4,-15,10.740222574620182,0
2175,2174,2171,2171,2157,2189,2190,2179,2183,2200,2193,2171,2182,2175,2184,9,5,10.80872663307623,0
2174,2171,2171,2157,2189,2190,2179,2183,2200,2193,2171,2182,2175,2184,2185,11,2,10.813131346830552,0
2171,2171,2157,2189,2190,2179,2183,2200,2193,2171,2182,2175,2184,2185,2205,34,5,12.378937564997056,0
2171,2157,2189,2190,2179,2183,2200,2193,2171,2182,2175,2184,2185,2205,2198,27,5,12.574729003990882,0
2157,2189,2190,2179,2183,2200,2193,2171,2182,2175,2184,2185,2205,2198,2176,19,5,12.264156057777633,0
2189,2190,2179,2183,2200,2193,2171,2182,2175,2184,2185,2205,2198,2176,2187,-2,5,9.627836625911248,0
2190,2179,2183,2200,2193,2171,2182,2175,2184,2185,2205,2198,2176,2187,2179,-11,4,9.784827905633147,0
2179,2183,2200,2193,2171,2182,2175,2184,2185,2205,2198,2176,2187,2179,2182,3,-2,9.75753676957068,0
2183,2200,2193,2171,2182,2175,2184,2185,2205,2198,2176,2187,2179,2182,2181,-2,-4,9.679138096220877,0
2200,2193,2171,2182,2175,2184,2185,2205,2198,2176,2187,2179,2182,2181,2196,-4,-9,10.02473132284542,0
2193,2171,2182,2175,2184,2185,2205,2198,2176,2187,2179,2182,2181,2196,2167,-26,-31,10.40924497513537,0
2171,2182,2175,2184,2185,2205,2198,2176,2187,2179,2182,2181,2196,2167,2186,15,10,10.133395989781228,0
2182,2175,2184,2185,2205,2198,2176,2187,2179,2182,2181,2196,2167,2186,2176,-6,-11,9.764854374356075,0
2175,2184,2185,2205,2198,2176,2187,2179,2182,2181,2196,2167,2186,2176,2200,25,21,10.582105290581472,0
2184,2185,2205,2198,2176,2187,2179,2182,2181,2196,2167,2186,2176,2200,2181,-3,-1,10.280818940883945,0
2185,2205,2198,2176,2187,2179,2182,2181,2196,2167,2186,2176,2200,2181,2184,-1,3,10.280818940883945,0
2205,2198,2176,2187,2179,2182,2181,2196,2167,2186,2176,2200,2181,2184,2179,-26,-17,10.41884739078085,0
2198,2176,2187,2179,2182,2181,2196,2167,2186,2176,2200,2181,2184,2179,2207,9,40,10.700244768005922,0
2176,2187,2179,2182,2181,2196,2167,2186,2176,2200,2181,2184,2179,2207,2191,15,5,10.248344814094198,0
2187,2179,2182,2181,2196,2167,2186,2176,2200,2181,2184,2179,2207,2191,2166,-21,-10,11.147495981908524,0
2179,2182,2181,2196,2167,2186,2176,2200,2181,2184,2179,2207,2191,2166,2208,29,8,12.738393409950357,0
2182,2181,2196,2167,2186,2176,2200,2181,2184,2179,2207,2191,2166,2208,2191,9,10,12.675435561221029,0
2181,2196,2167,2186,2176,2200,2181,2184,2179,2207,2191,2166,2208,2191,2184,3,0,12.637058126606766,0
2196,2167,2186,2176,2200,2181,2184,2179,2207,2191,2166,2208,2191,2184,2192,-4,13,12.616315966692836,0
2167,2186,2176,2200,2181,2184,2179,2207,2191,2166,2208,2191,2184,2192,2183,16,-24,12.413510305116684,0
2186,2176,2200,2181,2184,2179,2207,2191,2166,2208,2191,2184,2192,2183,2181,-5,-10,11.335574008193767,0
2176,2200,2181,2184,2179,2207,2191,2166,2208,2191,2184,2192,2183,2181,2186,10,20,11.335574008193767,0
2200,2181,2184,2179,2207,2191,2166,2208,2191,2184,2192,2183,2181,2186,2174,-26,-34,11.488296321950978,0
2181,2184,2179,2207,2191,2166,2208,2191,2184,2192,2183,2181,2186,2174,2177,-4,-14,11.179062061346139,0
2184,2179,2207,2191,2166,2208,2191,2184,2192,2183,2181,2186,2174,2177,2187,3,3,11.109841197270617,0
2179,2207,2191,2166,2208,2191,2184,2192,2183,2181,2186,2174,2177,2187,2183,4,-9,11.12568884972757,0
2207,2191,2166,2208,2191,2184,2192,2183,2181,2186,2174,2177,2187,2183,2183,-24,0,10.994803967589158,0
2191,2166,2208,2191,2184,2192,2183,2181,2186,2174,2177,2187,2183,2183,2180,-11,-1,9.447599846370656,0
2166,2208,2191,2184,2192,2183,2181,2186,2174,2177,2187,2183,2183,2180,2188,22,2,9.32891051669869,0
2208,2191,2184,2192,2183,2181,2186,2174,2177,2187,2183,2183,2180,2188,2185,-23,11,7.854631633325531,0
2191,2184,2192,2183,2181,2186,2174,2177,2187,2183,2183,2180,2188,2185,2190,-1,13,5.035114790387698,0
2184,2192,2183,2181,2186,2174,2177,2187,2183,2183,2180,2188,2185,2190,2185,1,-2,4.688384837121669,0
2192,2183,2181,2186,2174,2177,2187,2183,2183,2180,2188,2185,2190,2185,2187,-5,4,4.757950739351474,0
2183,2181,2186,2174,2177,2187,2183,2183,2180,2188,2185,2190,2185,2187,2178,-5,-5,4.4539976692961165,0
2181,2186,2174,2177,2187,2183,2183,2180,2188,2185,2190,2185,2187,2178,2187,6,7,4.563832975533989,0
2186,2174,2177,2187,2183,2183,2180,2188,2185,2190,2185,2187,2178,2187,2187,1,-1,4.6012420683363935,0
2174,2177,2187,2183,2183,2180,2188,2185,2190,2185,2187,2178,2187,2187,2180,6,-5,4.656792274271453,0
2177,2187,2183,2183,2180,2188,2185,2190,2185,2187,2178,2187,2187,2180,2196,19,6,4.940599539481399,0
2187,2183,2183,2180,2188,2185,2190,2185,2187,2178,2187,2187,2180,2196,2189,2,4,4.5303211281110665,0
2183,2183,2180,2188,2185,2190,2185,2187,2178,2187,2187,2180,2196,2189,2211,28,24,7.968389931174182,0
2183,2180,2188,2185,2190,2185,2187,2178,2187,2187,2180,2196,2189,2211,2190,7,12,7.9053929753832035,0
2180,2188,2185,2190,2185,2187,2178,2187,2187,2180,2196,2189,2211,2190,2046,-134,-141,37.501999946669514,0
2188,2185,2190,2185,2187,2178,2187,2187,2180,2196,2189,2211,2190,2046,2045,-143,-142,50.93525301792463,0
2185,2190,2185,2187,2178,2187,2187,2180,2196,2189,2211,2190,2046,2045,2037,-148,-143,60.971734278699834,0
2190,2185,2187,2178,2187,2187,2180,2196,2189,2211,2190,2046,2045,2037,2042,-148,-154,67.53200299540528,0
2185,2187,2178,2187,2187,2180,2196,2189,2211,2190,2046,2045,2037,2042,2079,-106,-110,68.90345212168774,0
2187,2178,2187,2187,2180,2196,2189,2211,2190,2046,2045,2037,2042,2079,2106,-81,-105,68.44879907812916,0
2178,2187,2187,2180,2196,2189,2211,2190,2046,2045,2037,2042,2079,2106,2099,-79,-91,67.65444412249508,0
2187,2187,2180,2196,2189,2211,2190,2046,2045,2037,2042,2079,2106,2099,2120,-67,74,66.4517010424005,0
2187,2180,2196,2189,2211,2190,2046,2045,2037,2042,2079,2106,2099,2120,2119,-68,74,64.39772252701695,0
2180,2196,2189,2211,2190,2046,2045,2037,2042,2079,2106,2099,2120,2119,2117,-63,80,61.922532247962856,0
2196,2189,2211,2190,2046,2045,2037,2042,2079,2106,2099,2120,2119,2117,2119,-77,77,59.545500809604974,0
2189,2211,2190,2046,2045,2037,2042,2079,2106,2099,2120,2119,2117,2119,2107,-82,28,55.09446433172756,0
2211,2190,2046,2045,2037,2042,2079,2106,2099,2120,2119,2117,2119,2107,2101,-110,-5,50.3826311719577,0
2190,2046,2045,2037,2042,2079,2106,2099,2120,2119,2117,2119,2107,2101,2097,-93,-2,40.47656582459017,0
2046,2045,2037,2042,2079,2106,2099,2120,2119,2117,2119,2107,2101,2097,2098,52,-22,30.873474514078076,0
2045,2037,2042,2079,2106,2099,2120,2119,2117,2119,2107,2101,2097,2098,2094,49,-25,28.51816463739759,0
2037,2042,2079,2106,2099,2120,2119,2117,2119,2107,2101,2097,2098,2094,2098,61,-19,25.39084949534454,0
2042,2079,2106,2099,2120,2119,2117,2119,2107,2101,2097,2098,2094,2098,2098,56,-21,19.56235451794375,0
2079,2106,2099,2120,2119,2117,2119,2107,2101,2097,2098,2094,2098,2098,2100,21,-7,11.388381715381605,0
2106,2099,2120,2119,2117,2119,2107,2101,2097,2098,2094,2098,2098,2100,2102,-4,1,9.19627253681776,0
2099,2120,2119,2117,2119,2107,2101,2097,2098,2094,2098,2098,2100,2102,2097,-2,0,9.417309291178361,0
2120,2119,2117,2119,2107,2101,2097,2098,2094,2098,2098,2100,2102,2097,2097,-23,-1,9.512898511770116,0
2119,2117,2119,2107,2101,2097,2098,2094,2098,2098,2100,2102,2097,2097,2093,-26,-1,8.854915234462938,0
2117,2119,2107,2101,2097,2098,2094,2098,2098,2100,2102,2097,2097,2093,2091,-26,-7,8.033856928204356,0
2119,2107,2101,2097,2098,2094,2098,2098,2100,2102,2097,2097,2093,2091,2091,-28,-7,6.978197338513586,0
2107,2101,2097,2098,2094,2098,2098,2100,2102,2097,2097,2093,2091,2091,2095,-12,-5,4.250490167812021,0
2101,2097,2098,2094,2098,2098,2100,2102,2097,2097,2093,2091,2091,2095,2098,-3,-4,3.3094381626464866,0
2097,2098,2094,2098,2098,2100,2102,2097,2097,2093,2091,2091,2095,2098,2099,2,2,3.1592645316516914,0
2098,2094,2098,2098,2100,2102,2097,2097,2093,2091,2091,2095,2098,2099,2102,4,5,3.461351236287988,0
2094,2098,2098,2100,2102,2097,2097,2093,2091,2091,2095,2098,2099,2102,2104,10,11,3.9182114481458186,0
2098,2098,2100,2102,2097,2097,2093,2091,2091,2095,2098,2099,2102,2104,2103,5,12,4.068461742769735,0
2098,2100,2102,2097,2097,2093,2091,2091,2095,2098,2099,2102,2104,2103,2099,1,8,4.078982132603088,0
2100,2102,2097,2097,2093,2091,2091,2095,2098,2099,2102,2104,2103,2099,2095,-5,0,4.14843630896315,0
2102,2097,2097,2093,2091,2091,2095,2098,2099,2102,2104,2103,2099,2095,2094,-8,-4,4.203173404306164,0
2097,2097,2093,2091,2091,2095,2098,2099,2102,2104,2103,2099,2095,2094,2094,-3,-5,4.0743097574926725,0
2097,2093,2091,2091,2095,2098,2099,2102,2104,2103,2099,2095,2094,2094,2098,1,-4,4.085980677296223,0
2093,2091,2091,2095,2098,2099,2102,2104,2103,2099,2095,2094,2094,2098,2100,7,-4,4.1656189158852435,0
2091,2091,2095,2098,2099,2102,2104,2103,2099,2095,2094,2094,2098,2100,2103,12,0,4.267261863247182,0
2091,2095,2098,2099,2102,2104,2103,2099,2095,2094,2094,2098,2100,2103,2106,15,7,4.333699618219101,0
2095,2098,2099,2102,2104,2103,2099,2095,2094,2094,2098,2100,2103,2106,2101,6,6,3.794733192202055,0
2098,2099,2102,2104,2103,2099,2095,2094,2094,2098,2100,2103,2106,2101,2105,7,11,3.8446004188930196,0
2099,2102,2104,2103,2099,2095,2094,2094,2098,2100,2103,2106,2101,2105,2101,2,7,3.8072612328599273,0
2102,2104,2103,2099,2095,2094,2094,2098,2100,2103,2106,2101,2105,2101,2098,-4,0,3.8396428405331067,0
2104,2103,2099,2095,2094,2094,2098,2100,2103,2106,2101,2105,2101,2098,2093,-11,-7,4.222389303293981,0
2103,2099,2095,2094,2094,2098,2100,2103,2106,2101,2105,2101,2098,2093,2096,-7,-7,4.131182235954578,0
2099,2095,2094,2094,2098,2100,2103,2106,2101,2105,2101,2098,2093,2096,2097,-2,-9,4.011887099014389,0
2095,2094,2094,2098,2100,2103,2106,2101,2105,2101,2098,2093,2096,2097,2100,5,-1,4.026105290417006,0
2094,2094,2098,2100,2103,2106,2101,2105,2101,2098,2093,2096,2097,2100,2101,7,-4,3.925496632214045,0
2094,2098,2100,2103,2106,2101,2105,2101,2098,2093,2096,2097,2100,2101,2106,12,5,4.026105290417006,0
2098,2100,2103,2106,2101,2105,2101,2098,2093,2096,2097,2100,2101,2106,2106,8,8,3.954503159449394,0
2100,2103,2106,2101,2105,2101,2098,2093,2096,2097,2100,2101,2106,2106,2104,4,11,3.9617216074881,0
2103,2106,2101,2105,2101,2098,2093,2096,2097,2100,2101,2106,2106,2104,2102,-1,6,3.954503159449394,0
2106,2101,2105,2101,2098,2093,2096,2097,2100,2101,2106,2106,2104,2102,2098,-8,1,4.00832467081531,0
2101,2105,2101,2098,2093,2096,2097,2100,2101,2106,2106,2104,2102,2098,2095,-6,-5,4.021371478914697,0
2105,2101,2098,2093,2096,2097,2100,2101,2106,2106,2104,2102,2098,2095,2093,-12,-8,4.418575508442684,0
2101,2098,2093,2096,2097,2100,2101,2106,2106,2104,2102,2098,2095,2093,2093,-8,-13,4.470005859163093,0
2098,2093,2096,2097,2100,2101,2106,2106,2104,2102,2098,2095,2093,2093,2097,-1,-9,4.452928410447605,0
2093,2096,2097,2100,2101,2106,2106,2104,2102,2098,2095,2093,2093,2097,2099,6,-5,4.450789122113495,0
2096,2097,2100,2101,2106,2106,2104,2102,2098,2095,2093,2093,2097,2099,2101,5,-1,4.1952353926806065,0
2097,2100,2101,2106,2106,2104,2102,2098,2095,2093,2093,2097,2099,2101,2101,4,3,4.120795115138871,0
2100,2101,2106,2106,2104,2102,2098,2095,2093,2093,2097,2099,2101,2101,2102,2,7,4.103424818136094,0
2101,2106,2106,2104,2102,2098,2095,2093,2093,2097,2099,2101,2101,2102,2098,-3,5,4.131182235954578,0
2106,2106,2104,2102,2098,2095,2093,2093,2097,2099,2101,2101,2102,2098,2098,-8,5,4.138092498218174,0
2106,2104,2102,2098,2095,2093,2093,2097,2099,2101,2101,2102,2098,2098,2092,-14,-5,4.154171741411621,0
2104,2102,2098,2095,2093,2093,2097,2099,2101,2101,2102,2098,2098,2092,2091,-13,-8,4.049691346263317,0
2102,2098,2095,2093,2093,2097,2099,2101,2101,2102,2098,2098,2092,2091,2094,-8,-7,3.731462116089285,0
2098,2095,2093,2093,2097,2099,2101,2101,2102,2098,2098,2092,2091,2094,2097,-1,-4,3.4599752269963684,0
2095,2093,2093,2097,2099,2101,2101,2102,2098,2098,2092,2091,2094,2097,2100,5,-2,3.5550098787619757,0
2093,2093,2097,2099,2101,2101,2102,2098,2098,2092,2091,2094,2097,2100,2101,8,3,3.6813558578845584,0
2093,2097,2099,2101,2101,2102,2098,2098,2092,2091,2094,2097,2100,2101,2104,11,6,3.888934240098375,0
2097,2099,2101,2101,2102,2098,2098,2092,2091,2094,2097,2100,2101,2104,2101,4,9,3.7186787208054732,0
2099,2101,2101,2102,2098,2098,2092,2091,2094,2097,2100,2101,2104,2101,2099,0,8,3.700707783010987,0
2101,2101,2102,2098,2098,2092,2091,2094,2097,2100,2101,2104,2101,2099,2097,-4,3,3.7186787208054732,0
2101,2102,2098,2098,2092,2091,2094,2097,2100,2101,2104,2101,2099,2097,2094,-7,-3,3.8072612328599273,0
2102,2098,2098,2092,2091,2094,2097,2100,2101,2104,2101,2099,2097,2094,2091,-11,-9,4.0964560757992245,0
2098,2098,2092,2091,2094,2097,2100,2101,2104,2101,2099,2097,2094,2091,2092,-6,-9,4.08481508586549,0
2098,2092,2091,2094,2097,2100,2101,2104,2101,2099,2097,2094,2091,2092,2098,0,-6,4.08481508586549,0
2092,2091,2094,2097,2100,2101,2104,2101,2099,2097,2094,2091,2092,2098,2100,8,-1,4.1656189158852435,0
2091,2094,2097,2100,2101,2104,2101,2099,2097,2094,2091,2092,2098,2100,2104,13,5,4.34028746030666,0
2094,2097,2100,2101,2104,2101,2099,2097,2094,2091,2092,2098,2100,2104,2104,10,7,4.239272174728649,0
2097,2100,2101,2104,2101,2099,2097,2094,2091,2092,2098,2100,2104,2104,2103,6,9,4.20883424647321,0
2100,2101,2104,2101,2099,2097,2094,2091,2092,2098,2100,2104,2104,2103,2099,-1,8,4.172472146045292,0
2101,2104,2101,2099,2097,2094,2091,2092,2098,2100,2104,2104,2103,2099,2098,-3,6,4.174754056057845,0
2104,2101,2099,2097,2094,2091,2092,2098,2100,2104,2104,2103,2099,2098,2096,-8,-2,4.203173404306164,0
2101,2099,2097,2094,2091,2092,2098,2100,2104,2104,2103,2099,2098,2096,2093,-8,-7,4.1656189158852435,0
2099,2097,2094,2091,2092,2098,2100,2104,2104,2103,2099,2098,2096,2093,2094,-5,-10,4.1895561760622035,0
2097,2094,2091,2092,2098,2100,2104,2104,2103,2099,2098,2096,2093,2094,2096,-1,-8,4.182730937466346,0
2094,2091,2092,2098,2100,2104,2104,2103,2099,2098,2096,2093,2094,2096,2098,4,-5,4.186144947778269,0
2091,2092,2098,2100,2104,2104,2103,2099,2098,2096,2093,2094,2096,2098,2103,12,4,4.317186032370535,0
2092,2098,2100,2104,2104,2103,2099,2098,2096,2093,2094,2096,2098,2103,2105,13,7,4.2235169276439795,0
2098,2100,2104,2104,2103,2099,2098,2096,2093,2094,2096,2098,2103,2105,2105,7,9,4.043807729403186,0
2100,2104,2104,2103,2099,2098,2096,2093,2094,2096,2098,2103,2105,2105,2101,1,8,4.026105290417006,0
2104,2104,2103,2099,2098,2096,2093,2094,2096,2098,2103,2105,2105,2101,2100,-4,6,4.026105290417006,0
2104,2103,2099,2098,2096,2093,2094,2096,2098,2103,2105,2105,2101,2100,2094,-10,-2,4.131182235954578,0
2103,2099,2098,2096,2093,2094,2096,2098,2103,2105,2105,2101,2100,2094,2093,-10,-5,4.206570823751586,0
2099,2098,2096,2093,2094,2096,2098,2103,2105,2105,2101,2100,2094,2093,2092,-7,-11,4.329302154257328,0
2098,2096,2093,2094,2096,2098,2103,2105,2105,2101,2100,2094,2093,2092,2093,-5,-12,4.484895284651104,0
2096,2093,2094,2096,2098,2103,2105,2105,2101,2100,2094,2093,2092,2093,2097,1,-8,4.482771251718974,0
2093,2094,2096,2098,2103,2105,2105,2101,2100,2094,2093,2092,2093,2097,2099,6,-2,4.485956923980604,0
2094,2096,2098,2103,2105,2105,2101,2100,2094,2093,2092,2093,2097,2099,2103,9,3,4.5071371971891105,0
2096,2098,2103,2105,2105,2101,2100,2094,2093,2092,2093,2097,2099,2103,2102,6,8,4.4475782602392036,0
2098,2103,2105,2105,2101,2100,2094,2093,2092,2093,2097,2099,2103,2102,2099,1,6,4.382867076415141,0
2103,2105,2105,2101,2100,2094,2093,2092,2093,2097,2099,2103,2102,2099,2096,-7,4,4.443293501768384,0
2105,2105,2101,2100,2094,2093,2092,2093,2097,2099,2103,2102,2099,2096,2095,-10,2,4.382867076415141,0
2105,2101,2100,2094,2093,2092,2093,2097,2099,2103,2102,2099,2096,2095,2092,-13,-5,4.239272174728649,0
2101,2100,2094,2093,2092,2093,2097,2099,2103,2102,2099,2096,2095,2092,2093,-8,-6,3.813509819425819,0
2100,2094,2093,2092,2093,2097,2099,2103,2102,2099,2096,2095,2092,2093,2095,-5,-8,3.629246281451367,0
2094,2093,2092,2093,2097,2099,2103,2102,2099,2096,2095,2092,2093,2095,2098,4,-4,3.5145954180219596,0
2093,2092,2093,2097,2099,2103,2102,2099,2096,2095,2092,2093,2095,2098,2099,6,0,3.541589635016618,0
2092,2093,2097,2099,2103,2102,2099,2096,2095,2092,2093,2095,2098,2099,2103,11,7,3.7884536360342267,0
2093,2097,2099,2103,2102,2099,2096,2095,2092,2093,2095,2098,2099,2103,2103,10,8,3.80225497003329,0
2097,2099,2103,2102,2099,2096,2095,2092,2093,2095,2098,2099,2103,2103,2101,4,9,3.6384193323605842,0
2099,2103,2102,2099,2096,2095,2092,2093,2095,2098,2099,2103,2103,2101,2098,-1,5,3.621365172733304,0
2103,2102,2099,2096,2095,2092,2093,2095,2098,2099,2103,2103,2101,2098,2094,-9,-1,3.7884536360342267,0
2102,2099,2096,2095,2092,2093,2095,2098,2099,2103,2103,2101,2098,2094,2092,-10,-6,3.8297084310253524,0
2099,2096,2095,2092,2093,2095,2098,2099,2103,2103,2101,2098,2094,2092,2089,-10,-10,4.155317877932646,0
2096,2095,2092,2093,2095,2098,2099,2103,2103,2101,2098,2094,2092,2089,2092,-4,-11,4.242640687119285,0
2095,2092,2093,2095,2098,2099,2103,2103,2101,2098,2094,2092,2089,2092,2096,1,-7,4.242640687119285,0
2092,2093,2095,2098,2099,2103,2103,2101,2098,2094,2092,2089,2092,2096,2098,6,-3,4.262795863213317,0
2093,2095,2098,2099,2103,2103,2101,2098,2094,2092,2089,2092,2096,2098,2102,9,4,4.34028746030666,0
2095,2098,2099,2103,2103,2101,2098,2094,2092,2089,2092,2096,2098,2102,2104,9,10,4.563832975533989,0
2098,2099,2103,2103,2101,2098,2094,2092,2089,2092,2096,2098,2102,2104,2100,2,8,4.542917040635372,0
2099,2103,2103,2101,2098,2094,2092,2089,2092,2096,2098,2102,2104,2100,2098,-1,9,4.542917040635372,0
2103,2103,2101,2098,2094,2092,2089,2092,2096,2098,2102,2104,2100,2098,2095,-8,3,4.592955268151226,0
2103,2101,2098,2094,2092,2089,2092,2096,2098,2102,2104,2100,2098,2095,2092,-11,-4,4.5586129887228175,0
2101,2098,2094,2092,2089,2092,2096,2098,2102,2104,2100,2098,2095,2092,2092,-9,-6,4.394802124588286,0
2098,2094,2092,2089,2092,2096,2098,2102,2104,2100,2098,2095,2092,2092,2092,-6,-10,4.306141793166725,0
2094,2092,2089,2092,2096,2098,2102,2104,2100,2098,2095,2092,2092,2092,2095,1,-9,4.2560880764248425,0
2092,2089,2092,2096,2098,2102,2104,2100,2098,2095,2092,2092,2092,2095,2100,8,0,4.394802124588286,0
2089,2092,2096,2098,2102,2104,2100,2098,2095,2092,2092,2092,2095,2100,2104,15,6,4.732863826479693,0
2092,2096,2098,2102,2104,2100,2098,2095,2092,2092,2092,2095,2100,2104,2104,12,9,4.595028369257987,0
2096,2098,2102,2104,2100,2098,2095,2092,2092,2092,2095,2100,2104,2104,2101,5,9,4.394802124588286,0
2098,2102,2104,2100,2098,2095,2092,2092,2092,2095,2100,2104,2104,2101,2097,-1,5,4.366539438350084,0
2102,2104,2100,2098,2095,2092,2092,2092,2095,2100,2104,2104,2101,2097,2095,-7,3,4.4475782602392036,0
2104,2100,2098,2095,2092,2092,2092,2095,2100,2104,2104,2101,2097,2095,2094,-10,-1,4.421807430495018,0
2100,2098,2095,2092,2092,2092,2095,2100,2104,2104,2101,2097,2095,2094,2092,-8,-8,4.250490167812021,0
2098,2095,2092,2092,2092,2095,2100,2104,2104,2101,2097,2095,2094,2092,2093,-5,-11,4.250490167812021,0
2095,2092,2092,2092,2095,2100,2104,2104,2101,2097,2095,2094,2092,2093,2098,3,-6,4.250490167812021,0
2092,2092,2092,2095,2100,2104,2104,2101,2097,2095,2094,2092,2093,2098,2100,8,-1,4.339190181194116,0
2092,2092,2095,2100,2104,2104,2101,2097,2095,2094,2092,2093,2098,2100,2103,11,6,4.43471156521669,0
2092,2095,2100,2104,2104,2101,2097,2095,2094,2092,2093,2098,2100,2103,2104,12,9,4.485956923980604,0
2095,2100,2104,2104,2101,2097,2095,2094,2092,2093,2098,2100,2103,2104,2102,7,8,4.246006527146588,0
2100,2104,2104,2101,2097,2095,2094,2092,2093,2098,2100,2103,2104,2102,2100,0,8,4.120795115138871,0
2104,2104,2101,2097,2095,2094,2092,2093,2098,2100,2103,2104,2102,2100,2096,-8,3,4.1895561760622035,0
2104,2101,2097,2095,2094,2092,2093,2098,2100,2103,2104,2102,2100,2096,2092,-12,-6,4.283967898150143,0
2101,2097,2095,2094,2092,2093,2098,2100,2103,2104,2102,2100,2096,2092,2092,-9,-8,4.216746658379227,0
2097,2095,2094,2092,2093,2098,2100,2103,2104,2102,2100,2096,2092,2092,2095,-2,-8,4.120795115138871,0
2095,2094,2092,2093,2098,2100,2103,2104,2102,2100,2096,2092,2092,2095,2096,1,-8,4.126568965687043,0
2094,2092,2093,2098,2100,2103,2104,2102,2100,2096,2092,2092,2095,2096,2100,6,-2,4.172472146045292,0
2092,2093,2098,2100,2103,2104,2102,2100,2096,2092,2092,2095,2096,2100,2099,7,-1,4.103424818136094,0
2093,2098,2100,2103,2104,2102,2100,2096,2092,2092,2095,2096,2100,2099,2103,10,7,4.039094665180022,0
2098,2100,2103,2104,2102,2100,2096,2092,2092,2095,2096,2100,2099,2103,2103,5,11,3.9436507137905803,0
2100,2103,2104,2102,2100,2096,2092,2092,2095,2096,2100,2099,2103,2103,2100,0,8,3.946064947695181,0
2103,2104,2102,2100,2096,2092,2092,2095,2096,2100,2099,2103,2103,2100,2096,-7,1,4.00832467081531,0
2104,2102,2100,2096,2092,2092,2095,2096,2100,2099,2103,2103,2100,2096,2093,-11,-3,4.078982132603088,0
2102,2100,2096,2092,2092,2095,2096,2100,2099,2103,2103,2100,2096,2093,2090,-12,-10,4.2235169276439795,0
2100,2096,2092,2092,2095,2096,2100,2099,2103,2103,2100,2096,2093,2090,2091,-9,-8,4.272837799067834,0
2096,2092,2092,2095,2096,2100,2099,2103,2103,2100,2096,2093,2090,2091,2095,-1,-8,4.1656189158852435,0
2092,2092,2095,2096,2100,2099,2103,2103,2100,2096,2093,2090,2091,2095,2098,6,-5,4.1952353926806065,0
2092,2095,2096,2100,2099,2103,2103,2100,2096,2093,2090,2091,2095,2098,2101,9,1,4.1952353926806065,0
2095,2096,2100,2099,2103,2103,2100,2096,2093,2090,2091,2095,2098,2101,2103,8,7,4.257206774847743,0
2096,2100,2099,2103,2103,2100,2096,2093,2090,2091,2095,2098,2101,2103,2099,3,6,4.212227100104783,0
2100,2099,2103,2103,2100,2096,2093,2090,2091,2095,2098,2101,2103,2099,2096,-4,6,4.212227100104783,0
2099,2103,2103,2100,2096,2093,2090,2091,2095,2098,2101,2103,2099,2096,2096,-3,5,4.1895561760622035,0
2103,2103,2100,2096,2093,2090,2091,2095,2098,2101,2103,2099,2096,2096,2092,-11,-3,4.399134113934349,0
2103,2100,2096,2093,2090,2091,2095,2098,2101,2103,2099,2096,2096,2092,2088,-15,-10,4.651676605063516,0
2100,2096,2093,2090,2091,2095,2098,2101,2103,2099,2096,2096,2092,2088,2091,-9,-10,4.399134113934349,0
2096,2093,2090,2091,2095,2098,2101,2103,2099,2096,2096,2092,2088,2091,2095,-1,-8,4.199773236508757,0
2093,2090,2091,2095,2098,2101,2103,2099,2096,2096,2092,2088,2091,2095,2099,6,0,4.3237990350197935,0
2090,2091,2095,2098,2101,2103,2099,2096,2096,2092,2088,2091,2095,2099,2102,12,6,4.6208636587093705,0
2091,2095,2098,2101,2103,2099,2096,2096,2092,2088,2091,2095,2099,2102,2103,12,7,4.68736904578982,0
2095,2098,2101,2103,2099,2096,2096,2092,2088,2091,2095,2099,2102,2103,2102,7,10,4.6084807950229365,0
2098,2101,2103,2099,2096,2096,2092,2088,2091,2095,2099,2102,2103,2102,2099,1,11,4.579457235462361,0
2101,2103,2099,2096,2096,2092,2088,2091,2095,2099,2102,2103,2102,2099,2095,-6,4,4.626013402488151,0
2103,2099,2096,2096,2092,2088,2091,2095,2099,2102,2103,2102,2099,2095,2093,-10,-2,4.642454194968535,0
2099,2096,2096,2092,2088,2091,2095,2099,2102,2103,2102,2099,2095,2093,2089,-10,-10,4.727830469928142,0
2096,2096,2092,2088,2091,2095,2099,2102,2103,2102,2099,2095,2093,2089,2089,-7,-13,4.963677592077797,0
2096,2092,2088,2091,2095,2099,2102,2103,2102,2099,2095,2093,2089,2089,2094,-2,-9,4.96943035923013,0
2092,2088,2091,2095,2099,2102,2103,2102,2099,2095,2093,2089,2089,2094,2097,5,-5,4.98855833740714,0
2088,2091,2095,2099,2102,2103,2102,2099,2095,2093,2089,2089,2094,2097,2097,9,-2,4.926120853842978,0
2091,2095,2099,2102,2103,2102,2099,2095,2093,2089,2089,2094,2097,2097,2102,11,7,4.718756898449704,0
2095,2099,2102,2103,2102,2099,2095,2093,2089,2089,2094,2097,2097,2102,2102,7,9,4.662923668993215,0
2099,2102,2103,2102,2099,2095,2093,2089,2089,2094,2097,2097,2102,2102,2099,0,10,4.642454194968535,0
2102,2103,2102,2099,2095,2093,2089,2089,2094,2097,2097,2102,2102,2099,2096,-6,7,4.636295729916082,0
2103,2102,2099,2095,2093,2089,2089,2094,2097,2097,2102,2102,2099,2096,2093,-10,-1,4.561745697594706,0
2102,2099,2095,2093,2089,2089,2094,2097,2097,2102,2102,2099,2096,2093,2089,-13,-8,4.605379876787995,0
2099,2095,2093,2089,2089,2094,2097,2097,2102,2102,2099,2096,2093,2089,2089,-10,-8,4.564876256602718,0
2095,2093,2089,2089,2094,2097,2097,2102,2102,2099,2096,2093,2089,2089,2092,-3,-10,4.468940430507949,0
2093,2089,2089,2094,2097,2097,2102,2102,2099,2096,2093,2089,2089,2092,2096,3,-6,4.485956923980604,0
2089,2089,2094,2097,2097,2102,2102,2099,2096,2093,2089,2089,2092,2096,2098,9,-1,4.554432691659538,0
2089,2094,2097,2097,2102,2102,2099,2096,2093,2089,2089,2092,2096,2098,2100,11,4,4.437931736207543,0
2094,2097,2097,2102,2102,2099,2096,2093,2089,2089,2092,2096,2098,2100,2097,3,4,4.0614330100640705,0
2097,2097,2102,2102,2099,2096,2093,2089,2089,2092,2096,2098,2100,2097,2099,2,10,4.08481508586549,0
2097,2102,2102,2099,2096,2093,2089,2089,2092,2096,2098,2100,2097,2099,2096,-1,7,4.08248290463863,0
2102,2102,2099,2096,2093,2089,2089,2092,2096,2098,2100,2097,2099,2096,2092,-10,0,4.225771273642583,0
2102,2099,2096,2093,2089,2089,2092,2096,2098,2100,2097,2099,2096,2092,2089,-13,-7,4.2403953095144775,0
2099,2096,2093,2089,2089,2092,2096,2098,2100,2097,2099,2096,2092,2089,2089,-10,-9,4.0614330100640705,0
2096,2093,2089,2089,2092,2096,2098,2100,2097,2099,2096,2092,2089,2089,2090,-6,-10,3.9761191895520196,0
2093,2089,2089,2092,2096,2098,2100,2097,2099,2096,2092,2089,2089,2090,2096,3,-1,3.9761191895520196,0
2089,2089,2092,2096,2098,2100,2097,2099,2096,2092,2089,2089,2090,2096,2100,11,1,4.290632099064636,0
2089,2092,2096,2098,2100,2097,2099,2096,2092,2089,2089,2090,2096,2100,2101,12,5,4.382867076415141,0
2092,2096,2098,2100,2097,2099,2096,2092,2089,2089,2090,2096,2100,2101,2101,9,9,4.317186032370535,0
2096,2098,2100,2097,2099,2096,2092,2089,2089,2090,2096,2100,2101,2101,2099,3,10,4.262795863213317,0
2098,2100,2097,2099,2096,2092,2089,2089,2090,2096,2100,2101,2101,2099,2094,-4,5,4.3006090377106005,0
2100,2097,2099,2096,2092,2089,2089,2090,2096,2100,2101,2101,2099,2094,2091,-9,1,4.452928410447605,0
2097,2099,2096,2092,2089,2089,2090,2096,2100,2101,2101,2099,2094,2091,2092,-5,-4,4.366539438350084,0
2099,2096,2092,2089,2089,2090,2096,2100,2101,2101,2099,2094,2091,2092,2090,-9,-10,4.516635916254486,0
2096,2092,2089,2089,2090,2096,2100,2101,2101,2099,2094,2091,2092,2090,2094,-2,-7,4.350150517374028,0
2092,2089,2089,2090,2096,2100,2101,2101,2099,2094,2091,2092,2090,2094,2095,3,-6,4.329302154257328,0
2089,2089,2090,2096,2100,2101,2101,2099,2094,2091,2092,2090,2094,2095,2102,13,3,4.718756898449704,0
2089,2090,2096,2100,2101,2101,2099,2094,2091,2092,2090,2094,2095,2102,2106,17,12,5.223572942509206,0
2090,2096,2100,2101,2101,2099,2094,2091,2092,2090,2094,2095,2102,2106,2109,19,18,5.826867164470197,0
2096,2100,2101,2101,2099,2094,2091,2092,2090,2094,2095,2102,2106,2109,2109,13,17,6.173676839152314,0
2100,2101,2101,2099,2094,2091,2092,2090,2094,2095,2102,2106,2109,2109,2116,16,26,7.573135476959392,0
2101,2101,2099,2094,2091,2092,2090,2094,2095,2102,2106,2109,2109,2116,2115,14,21,8.514413549695487,0
2101,2099,2094,2091,2092,2090,2094,2095,2102,2106,2109,2109,2116,2115,2116,15,21,9.361522057768983,0
2099,2094,2091,2092,2090,2094,2095,2102,2106,2109,2109,2116,2115,2116,2115,16,13,9.941735021518893,1
2094,2091,2092,2090,2094,2095,2102,2106,2109,2109,2116,2115,2116,2115,2118,24,12,10.602335771400744,1
2091,2092,2090,2094,2095,2102,2106,2109,2109,2116,2115,2116,2115,2118,2118,27,9,10.773424092026948,1
2092,2090,2094,2095,2102,2106,2109,2109,2116,2115,2116,2115,2118,2118,2121,29,12,10.62656150990571,1
2090,2094,2095,2102,2106,2109,2109,2116,2115,2116,2115,2118,2118,2121,2122,32,6,10.271087483574371,1
2094,2095,2102,2106,2109,2109,2116,2115,2116,2115,2118,2118,2121,2122,2122,28,7,9.140699150085892,1
2095,2102,2106,2109,2109,2116,2115,2116,2115,2118,2118,2121,2122,2122,2123,28,7,8.099382692526634,1
2102,2106,2109,2109,2116,2115,2116,2115,2118,2118,2121,2122,2122,2123,2110,8,-5,6.349353172905546,1
2106,2109,2109,2116,2115,2116,2115,2118,2118,2121,2122,2122,2123,2110,2063,-43,-55,14.595498327517682,1
2109,2109,2116,2115,2116,2115,2118,2118,2121,2122,2122,2123,2110,2063,2098,-11,-20,14.979350866474567,1
2109,2116,2115,2116,2115,2118,2118,2121,2122,2122,2123,2110,2063,2098,2101,-8,-20,15.22153862443735,1
2116,2115,2116,2115,2118,2118,2121,2122,2122,2123,2110,2063,2098,2101,1961,-155,-161,41.67813175595407,1
2115,2116,2115,2118,2118,2121,2122,2122,2123,2110,2063,2098,2101,1961,2094,-21,-28,41.50937931875845,1
2116,2115,2118,2118,2121,2122,2122,2123,2110,2063,2098,2101,1961,2094,2078,-38,-45,41.64075384707127,1
2115,2118,2118,2121,2122,2122,2123,2110,2063,2098,2101,1961,2094,2078,1992,-123,-118,49.27831552470499,1
2118,2118,2121,2122,2122,2123,2110,2063,2098,2101,1961,2094,2078,1992,2020,-98,-43,51.750040257633295,1
2118,2121,2122,2122,2123,2110,2063,2098,2101,1961,2094,2078,1992,2020,2055,-63,-43,51.23735616390318,1
2121,2122,2122,2123,2110,2063,2098,2101,1961,2094,2078,1992,2020,2055,2034,-87,-67,51.20611942596965,1
2122,2122,2123,2110,2063,2098,2101,1961,2094,2078,1992,2020,2055,2034,2001,-121,40,52.517298737336695,1
2122,2123,2110,2063,2098,2101,1961,2094,2078,1992,2020,2055,2034,2001,2007,-115,-87,51.98278103189097,1
2123,2110,2063,2098,2101,1961,2094,2078,1992,2020,2055,2034,2001,2007,2016,-107,-62,49.70944147170205,1
2110,2063,2098,2101,1961,2094,2078,1992,2020,2055,2034,2001,2007,2016,2213,103,221,62.82538158601643,1
2063,2098,2101,1961,2094,2078,1992,2020,2055,2034,2001,2007,2016,2213,2203,140,183,72.37679186037468,1
2098,2101,1961,2094,2078,1992,2020,2055,2034,2001,2007,2016,2213,2203,2200,102,145,80.63131850471952,1
2101,1961,2094,2078,1992,2020,2055,2034,2001,2007,2016,2213,2203,2200,2195,94,161,86.57614320024062,1
1961,2094,2078,1992,2020,2055,2034,2001,2007,2016,2213,2203,2200,2195,2188,227,187,91.02684062564028,1
2094,2078,1992,2020,2055,2034,2001,2007,2016,2213,2203,2200,2195,2188,2200,106,193,88.88874801576138,1
2078,1992,2020,2055,2034,2001,2007,2016,2213,2203,2200,2195,2188,2200,2205,127,189,92.90691706269904,1
1992,2020,2055,2034,2001,2007,2016,2213,2203,2200,2195,2188,2200,2205,2224,232,11,97.18602682239772,1
2020,2055,2034,2001,2007,2016,2213,2203,2200,2195,2188,2200,2205,2224,2241,221,38,95.58680921151253,1
2055,2034,2001,2007,2016,2213,2203,2200,2195,2188,2200,2205,2224,2241,2231,176,31,93.19171228223698,0
2034,2001,2007,2016,2213,2203,2200,2195,2188,2200,2205,2224,2241,2231,2215,181,20,90.97425067410165,0
2001,2007,2016,2213,2203,2200,2195,2188,2200,2205,2224,2241,2231,2215,2208,207,20,84.896744006217,0
2007,2016,2213,2203,2200,2195,2188,2200,2205,2224,2241,2231,2215,2208,2206,199,6,71.17369765647446,0
2016,2213,2203,2200,2195,2188,2200,2205,2224,2241,2231,2215,2208,2206,2211,195,6,51.936041252220804,0
2213,2203,2200,2195,2188,2200,2205,2224,2241,2231,2215,2208,2206,2211,2199,-14,-25,14.012579382554126,0
2203,2200,2195,2188,2200,2205,2224,2241,2231,2215,2208,2206,2211,2199,2200,-3,-41,14.166358540066472,0
2200,2195,2188,2200,2205,2224,2241,2231,2215,2208,2206,2211,2199,2200,2194,-6,-37,14.595498327517682,0
2195,2188,2200,2205,2224,2241,2231,2215,2208,2206,2211,2199,2200,2194,2218,23,3,14.648256844124102,0
2188,2200,2205,2224,2241,2231,2215,2208,2206,2211,2199,2200,2194,2218,2201,13,-7,14.316823270943473,0
2200,2205,2224,2241,2231,2215,2208,2206,2211,2199,2200,2194,2218,2201,2218,18,12,13.16271791299741,0
2205,2224,2241,2231,2215,2208,2206,2211,2199,2200,2194,2218,2201,2218,2202,-3,-9,13.048627003124377,0
2224,2241,2231,2215,2208,2206,2211,2199,2200,2194,2218,2201,2218,2202,2209,-15,10,12.946041866145807,0
2241,2231,2215,2208,2206,2211,2199,2200,2194,2218,2201,2218,2202,2209,2226,-15,26,13.090163518932105,0
2231,2215,2208,2206,2211,2199,2200,2194,2218,2201,2218,2202,2209,2226,2222,-9,28,10.79461947100543,0
2215,2208,2206,2211,2199,2200,2194,2218,2201,2218,2202,2209,2226,2222,2222,7,4,9.78677436037801,0
2208,2206,2211,2199,2200,2194,2218,2201,2218,2202,2209,2226,2222,2222,2219,11,18,9.983319421247957,0
2206,2211,2199,2200,2194,2218,2201,2218,2202,2209,2226,2222,2222,2219,2212,6,-6,9.969954864491614,0
2211,2199,2200,2194,2218,2201,2218,2202,2209,2226,2222,2222,2219,2212,2197,-14,-5,10.522085616183025,0
2199,2200,2194,2218,2201,2218,2202,2209,2226,2222,2222,2219,2212,2197,2232,33,23,11.963038314503793,0
2200,2194,2218,2201,2218,2202,2209,2226,2222,2222,2219,2212,2197,2232,2205,5,-21,11.614030923228777,0
2194,2218,2201,2218,2202,2209,2226,2222,2222,2219,2212,2197,2232,2205,2209,15,-13,11.185449732321258,0
2218,2201,2218,2202,2209,2226,2222,2222,2219,2212,2197,2232,2205,2209,2240,22,18,12.052662223204742,0
2201,2218,2202,2209,2226,2222,2222,2219,2212,2197,2232,2205,2209,2240,2217,16,-2,12.04040815634705,0
2218,2202,2209,2226,2222,2222,2219,2212,2197,2232,2205,2209,2240,2217,2233,15,21,12.14123238429789,0
2202,2209,2226,2222,2222,2219,2212,2197,2232,2205,2209,2240,2217,2233,2232,30,35,12.704704790333533,0
2209,2226,2222,2222,2219,2212,2197,2232,2205,2209,2240,2217,2233,2232,2227,18,-5,12.011105971835677,0
2226,2222,2222,2219,2212,2197,2232,2205,2209,2240,2217,2233,2232,2227,2231,5,26,11.897178537067397,0
2222,2222,2219,2212,2197,2232,2205,2209,2240,2217,2233,2232,2227,2231,2218,-4,9,11.865114933322491,0
2222,2219,2212,2197,2232,2205,2209,2240,2217,2233,2232,2227,2231,2218,2231,9,-9,12.14005569925247,0
2219,2212,2197,2232,2205,2209,2240,2217,2233,2232,2227,2231,2218,2231,2197,-22,-20,13.706098746804026,0
2212,2197,2232,2205,2209,2240,2217,2233,2232,2227,2231,2218,2231,2197,2223,11,-10,13.724153196185949,0
2197,2232,2205,2209,2240,2217,2233,2232,2227,2231,2218,2231,2197,2223,2224,27,-8,13.556583359421811,0
2232,2205,2209,2240,2217,2233,2232,2227,2231,2218,2231,2197,2223,2224,2227,-5,0,11.859093356496324,0
2205,2209,2240,2217,2233,2232,2227,2231,2218,2231,2197,2223,2224,2227,2219,14,-12,11.632466879999518,0
2209,2240,2217,2233,2232,2227,2231,2218,2231,2197,2223,2224,2227,2219,2251,42,33,12.780938187487683,0
2240,2217,2233,2232,2227,2231,2218,2231,2197,2223,2224,2227,2219,2251,2214,-26,-17,12.385475364312828,0
2217,2233,2232,2227,2231,2218,2231,2197,2223,2224,2227,2219,2251,2214,2232,15,35,11.88316135586502,0
2233,2232,2227,2231,2218,2231,2197,2223,2224,2227,2219,2251,2214,2232,2232,-1,9,11.786594483726397,0
2232,2227,2231,2218,2231,2197,2223,2224,2227,2219,2251,2214,2232,2232,2218,-14,-6,11.792653080060767,0
2227,2231,2218,2231,2197,2223,2224,2227,2219,2251,2214,2232,2232,2218,2213,-14,-14,12.013088100662781,0
2231,2218,2231,2197,2223,2224,2227,2219,2251,2214,2232,2232,2218,2213,2212,-19,-7,12.347353678304628,0
2218,2231,2197,2223,2224,2227,2219,2251,2214,2232,2232,2218,2213,2212,2229,11,-22,12.262991167776008,0
2231,2197,2223,2224,2227,2219,2251,2214,2232,2232,2218,2213,2212,2229,2207,-24,-7,12.875595224336326,0
2197,2223,2224,2227,2219,2251,2214,2232,2232,2218,2213,2212,2229,2207,2204,7,-28,13.394384039944645,0
2223,2224,2227,2219,2251,2214,2232,2232,2218,2213,2212,2229,2207,2204,2229,6,-3,11.913177977509172,0
2224,2227,2219,2251,2214,2232,2232,2218,2213,2212,2229,2207,2204,2229,2210,-14,-8,12.321873697963772,0
2227,2219,2251,2214,2232,2232,2218,2213,2212,2229,2207,2204,2229,2210,2212,-15,-1,12.5288239101453,0
2219,2251,2214,2232,2232,2218,2213,2212,2229,2207,2204,2229,2210,2212,2229,10,17,12.612163441165304,0
2251,2214,2232,2232,2218,2213,2212,2229,2207,2204,2229,2210,2212,2229,2221,-30,-8,12.603098636370948,0
2214,2232,2232,2218,2213,2212,2229,2207,2204,2229,2210,2212,2229,2221,2218,4,11,9.454150008380044,0
2232,2232,2218,2213,2212,2229,2207,2204,2229,2210,2212,2229,2221,2218,2207,-25,3,9.864800338287933,0
2232,2218,2213,2212,2229,2207,2204,2229,2210,2212,2229,2221,2218,2207,2221,-11,-8,9.148510157136958,0
2218,2213,2212,2229,2207,2204,2229,2210,2212,2229,2221,2218,2207,2221,2239,21,29,10.07448450766778,0
2213,2212,2229,2207,2204,2229,2210,2212,2229,2221,2218,2207,2221,2239,2214,1,2,10.125404165948613,0
2212,2229,2207,2204,2229,2210,2212,2229,2221,2218,2207,2221,2239,2214,2215,3,-14,10.072593650949235,0
2229,2207,2204,2229,2210,2212,2229,2221,2218,2207,2221,2239,2214,2215,2230,1,9,10.399175791516226,0
2207,2204,2229,2210,2212,2229,2221,2218,2207,2221,2239,2214,2215,2230,2218,11,0,10.02473132284542,0
2204,2229,2210,2212,2229,2221,2218,2207,2221,2239,2214,2215,2230,2218,2219,15,12,9.527903881806973,0
2229,2210,2212,2229,2221,2218,2207,2221,2239,2214,2215,2230,2218,2219,2201,-28,-20,9.891314130998733,0
2210,2212,2229,2221,2218,2207,2221,2239,2214,2215,2230,2218,2219,2201,2202,-8,-37,10.361099408478859,0
2212,2229,2221,2218,2207,2221,2239,2214,2215,2230,2218,2219,2201,2202,2220,8,6,10.19430279733781,0
2229,2221,2218,2207,2221,2239,2214,2215,2230,2218,2219,2201,2202,2220,2205,-24,-10,10.62656150990571,0
2221,2218,2207,2221,2239,2214,2215,2230,2218,2219,2201,2202,2220,2205,2206,-15,-24,10.470821134853525,0
2218,2207,2221,2239,2214,2215,2230,2218,2219,2201,2202,2220,2205,2206,2196,-22,-22,11.510657587437743,0
2207,2221,2239,2214,2215,2230,2218,2219,2201,2202,2220,2205,2206,2196,2216,9,-3,11.47336459971944,0
2221,2239,2214,2215,2230,2218,2219,2201,2202,2220,2205,2206,2196,2216,2198,-23,-3,12.081075322684688,0
2239,2214,2215,2230,2218,2219,2201,2202,2220,2205,2206,2196,2216,2198,2211,-28,9,11.902380714238083,0
2214,2215,2230,2218,2219,2201,2202,2220,2205,2206,2196,2216,2198,2211,2208,-6,-12,9.440036319542722,0
2215,2230,2218,2219,2201,2202,2220,2205,2206,2196,2216,2198,2211,2208,2219,4,14,9.654507952740202,0
2230,2218,2219,2201,2202,2220,2205,2206,2196,2216,2198,2211,2208,2219,2235,5,29,11.467137310385628,0
2218,2219,2201,2202,2220,2205,2206,2196,2216,2198,2211,2208,2219,2235,2235,17,39,12.075950125293307,0
2219,2201,2202,2220,2205,2206,2196,2216,2198,2211,2208,2219,2235,2235,2208,-11,-8,12.032495683811916,0
2201,2202,2220,2205,2206,2196,2216,2198,2211,2208,2219,2235,2235,2208,2230,29,32,12.804389128434863,0
2202,2220,2205,2206,2196,2216,2198,2211,2208,2219,2235,2235,2208,2230,2224,22,13,12.68407325293079,0
2220,2205,2206,2196,2216,2198,2211,2208,2219,2235,2235,2208,2230,2224,2204,-16,-4,12.556538801224908,0
2205,2206,2196,2216,2198,2211,2208,2219,2235,2235,2208,2230,2224,2204,2208,3,-11,12.55198713162107,0
2206,2196,2216,2198,2211,2208,2219,2235,2235,2208,2230,2224,2204,2208,2223,17,-12,12.538322208713724,0
2196,2216,2198,2211,2208,2219,2235,2235,2208,2230,2224,2204,2208,2223,2215,19,-20,12.30369669574768,0
2216,2198,2211,2208,2219,2235,2235,2208,2230,2224,2204,2208,2223,2215,2247,31,39,13.561851257251332,0
2198,2211,2208,2219,2235,2235,2208,2230,2224,2204,2208,2223,2215,2247,2247,49,17,15.358571362132427,0
2211,2208,2219,2235,2235,2208,2230,2224,2204,2208,2223,2215,2247,2247,2226,15,2,14.03397238676138,0
2208,2219,2235,2235,2208,2230,2224,2204,2208,2223,2215,2247,2247,2226,2233,25,29,13.87632447560884,0
2219,2235,2235,2208,2230,2224,2204,2208,2223,2215,2247,2247,2226,2233,2233,14,25,13.289093272304171,0
2235,2235,2208,2230,2224,2204,2208,2223,2215,2247,2247,2226,2233,2233,2245,10,22,14.014618218471876,0
2235,2208,2230,2224,2204,2208,2223,2215,2247,2247,2226,2233,2233,2245,2203,-32,-12,15.183637809920821,0
2208,2230,2224,2204,2208,2223,2215,2247,2247,2226,2233,2233,2245,2203,2214,6,-33,15.203383082158298,0
2230,2224,2204,2208,2223,2215,2247,2247,2226,2233,2233,2245,2203,2214,2214,-16,-33,14.826616992037374,0
2224,2204,2208,2223,2215,2247,2247,2226,2233,2233,2245,2203,2214,2214,2235,11,9,15.016498862758858,0
2204,2208,2223,2215,2247,2247,2226,2233,2233,2245,2203,2214,2214,2235,2211,7,-22,15.431260788536026,0
2208,2223,2215,2247,2247,2226,2233,2233,2245,2203,2214,2214,2235,2211,2200,-8,-33,15.828545642062544,0
2223,2215,2247,2247,2226,2233,2233,2245,2203,2214,2214,2235,2211,2200,2200,-23,-45,16.511756273579596,0
2215,2247,2247,2226,2233,2233,2245,2203,2214,2214,2235,2211,2200,2200,2219,4,16,16.545176249978635,0
2247,2247,2226,2233,2233,2245,2203,2214,2214,2235,2211,2200,2200,2219,2221,-26,7,16.41514979697544,0
2247,2226,2233,2233,2245,2203,2214,2214,2235,2211,2200,2200,2219,2221,2227,-20,13,15.10376805713758,0
2226,2233,2233,2245,2203,2214,2214,2235,2211,2200,2200,2219,2221,2227,2226,0,-9,13.495325469354546,0
2233,2233,2245,2203,2214,2214,2235,2211,2200,2200,2219,2221,2227,2226,2212,-21,1,13.569222878404258,0
2233,2245,2203,2214,2214,2235,2211,2200,2200,2219,2221,2227,2226,2212,2229,-4,29,13.322733882174413,0
2245,2203,2214,2214,2235,2211,2200,2200,2219,2221,2227,2226,2212,2229,2226,-19,26,12.923953397802526,0
2203,2214,2214,2235,2211,2200,2200,2219,2221,2227,2226,2212,2229,2226,2216,13,-3,10.702914600816964,0
2214,2214,2235,2211,2200,2200,2219,2221,2227,2226,2212,2229,2226,2216,2219,5,-2,9.996189750290334,0
2214,2235,2211,2200,2200,2219,2221,2227,2226,2212,2229,2226,2216,2219,2220,6,-7,9.9474811360656,0
2235,2211,2200,2200,2219,2221,2227,2226,2212,2229,2226,2216,2219,2220,2221,-14,-5,9.893720952488719,0
2211,2200,2200,2219,2221,2227,2226,2212,2229,2226,2216,2219,2220,2221,2220,9,8,8.841460771356086,0
2200,2200,2219,2221,2227,2226,2212,2229,2226,2216,2219,2220,2221,2220,2217,17,-12,8.645395140932376,0
2200,2219,2221,2227,2226,2212,2229,2226,2216,2219,2220,2221,2220,2217,2202,2,-24,8.355209381548963,0
2219,2221,2227,2226,2212,2229,2226,2216,2219,2220,2221,2220,2217,2202,2212,-7,-4,6.926828450377011,0
2221,2227,2226,2212,2229,2226,2216,2219,2220,2221,2220,2217,2202,2212,2230,9,11,7.4724892263619385,0
2227,2226,2212,2229,2226,2216,2219,2220,2221,2220,2217,2202,2212,2230,2244,17,24,9.737996273801475,0
2226,2212,2229,2226,2216,2219,2220,2221,2220,2217,2202,2212,2230,2244,2195,-31,-26,11.725836349499259,0
2212,2229,2226,2216,2219,2220,2221,2220,2217,2202,2212,2230,2244,2195,2221,9,1,11.591047448456974,0
2229,2226,2216,2219,2220,2221,2220,2217,2202,2212,2230,2244,2195,2221,2218,-11,1,11.437199124327766,0
2226,2216,2219,2220,2221,2220,2217,2202,2212,2230,2244,2195,2221,2218,2231,5,29,11.568841568545022,0
2216,2219,2220,2221,2220,2217,2202,2212,2230,2244,2195,2221,2218,2231,2210,-6,-2,11.660678735452262,0
2219,2220,2221,2220,2217,2202,2212,2230,2244,2195,2221,2218,2231,2210,2243,24,13,13.240630110167935,0
2220,2221,2220,2217,2202,2212,2230,2244,2195,2221,2218,2231,2210,2243,2212,-8,-32,13.408241957130413,0
2221,2220,2217,2202,2212,2230,2244,2195,2221,2218,2231,2210,2243,2212,2233,12,38,13.839900907985474,0
2220,2217,2202,2212,2230,2244,2195,2221,2218,2231,2210,2243,2212,2233,2215,-5,-6,13.914021704740868,0
2217,2202,2212,2230,2244,2195,2221,2218,2231,2210,2243,2212,2233,2215,2239,22,21,14.735121632474215,0
2202,2212,2230,2244,2195,2221,2218,2231,2210,2243,2212,2233,2215,2239,2236,34,5,15.13494851879803,0
2212,2230,2244,2195,2221,2218,2231,2210,2243,2212,2233,2215,2239,2236,2231,19,21,14.1151725188924,0
2230,2244,2195,2221,2218,2231,2210,2243,2212,2233,2215,2239,2236,2231,2237,7,-6,13.988090172238191,0
2244,2195,2221,2218,2231,2210,2243,2212,2233,2215,2239,2236,2231,2237,2245,1,33,14.782550846312335,0
2195,2221,2218,2231,2210,2243,2212,2233,2215,2239,2236,2231,2237,2245,2222,27,-11,14.08579155779056,0
2221,2218,2231,2210,2243,2212,2233,2215,2239,2236,2231,2237,2245,2222,2246,25,31,12.121213203463155,0
2218,2231,2210,2243,2212,2233,2215,2239,2236,2231,2237,2245,2222,2246,2218,0,-21,12.290918056299402,0
2231,2210,2243,2212,2233,2215,2239,2236,2231,2237,2245,2222,2246,2218,2219,-12,-17,12.22916108947711,0
2210,2243,2212,2233,2215,2239,2236,2231,2237,2245,2222,2246,2218,2219,2217,7,-14,12.60498767495289,0
2243,2212,2233,2215,2239,2236,2231,2237,2245,2222,2246,2218,2219,2217,2226,-17,-11,11.591047448456976,0
2212,2233,2215,2239,2236,2231,2237,2245,2222,2246,2218,2219,2217,2226,2223,11,-22,11.035440742487468,0
2233,2215,2239,2236,2231,2237,2245,2222,2246,2218,2219,2217,2226,2223,2222,-11,0,10.280355747040774,0
2215,2239,2236,2231,2237,2245,2222,2246,2218,2219,2217,2226,2223,2222,2238,23,-8,10.511671517662549,0
2239,2236,2231,2237,2245,2222,2246,2218,2219,2217,2226,2223,2222,2238,2232,-7,14,9.794070120425395,0
2236,2231,2237,2245,2222,2246,2218,2219,2217,2226,2223,2222,2238,2232,2220,-16,1,9.784827905633145,0
2231,2237,2245,2222,2246,2218,2219,2217,2226,2223,2222,2238,2232,2220,2201,-30,-16,11.891573647315305,0
2237,2245,2222,2246,2218,2219,2217,2226,2223,2222,2238,2232,2220,2201,2214,-23,-12,12.233832869001711,0
2245,2222,2246,2218,2219,2217,2226,2223,2222,2238,2232,2220,2201,2214,2259,14,36,14.785127662620976,0
2222,2246,2218,2219,2217,2226,2223,2222,2238,2232,2220,2201,2214,2259,2232,10,10,14.00238074995344,0
2246,2218,2219,2217,2226,2223,2222,2238,2232,2220,2201,2214,2259,2232,2233,-13,-5,14.069555108544867,0
2218,2219,2217,2226,2223,2222,2238,2232,2220,2201,2214,2259,2232,2233,2233,15,1,13.16488836695115,0
2219,2217,2226,2223,2222,2238,2232,2220,2201,2214,2259,2232,2233,2233,2073,-146,-147,41.671961568330104,0
2217,2226,2223,2222,2238,2232,2220,2201,2214,2259,2232,2233,2233,2073,2076,-141,-125,55.147594171070985,0
2226,2223,2222,2238,2232,2220,2201,2214,2259,2232,2233,2233,2073,2076,2077,-149,-137,64.34223969931269,0
2223,2222,2238,2232,2220,2201,2214,2259,2232,2233,2233,2073,2076,2077,2076,-147,-183,70.88165858534579,0
2222,2238,2232,2220,2201,2214,2259,2232,2233,2233,2073,2076,2077,2076,2081,-141,-151,75.12389766246157,0
2238,2232,2220,2201,2214,2259,2232,2233,2233,2073,2076,2077,2076,2081,2076,-162,-157,78.37589522538771,0
2232,2220,2201,2214,2259,2232,2233,2233,2073,2076,2077,2076,2081,2076,2101,-131,-132,77.62314333336664,0
2220,2201,2214,2259,2232,2233,2233,2073,2076,2077,2076,2081,2076,2101,2103,-117,30,76.0804711817566,0
2201,2214,2259,2232,2233,2233,2073,2076,2077,2076,2081,2076,2101,2103,2088,-113,12,75.07412210291778,0
2214,2259,2232,2233,2233,2073,2076,2077,2076,2081,2076,2101,2103,2088,2103,-111,26,73.78249889273975,0
2259,2232,2233,2233,2073,2076,2077,2076,2081,2076,2101,2103,2088,2103,2108,-151,32,70.68690186475918,0
2232,2233,2233,2073,2076,2077,2076,2081,2076,2101,2103,2088,2103,2108,2114,-118,33,60.69062844420365,0
2233,2233,2073,2076,2077,2076,2081,2076,2101,2103,2088,2103,2108,2114,2110,-123,34,51.8980685942119,0
2233,2073,2076,2077,2076,2081,2076,2101,2103,2088,2103,2108,2114,2110,2106,-127,5,39.23676604313625,0
2073,2076,2077,2076,2081,2076,2101,2103,2088,2103,2108,2114,2110,2106,2105,32,2,15.17454008089427,0
2076,2077,2076,2081,2076,2101,2103,2088,2103,2108,2114,2110,2106,2105,2108,32,20,14.535015193203847,0
2077,2076,2081,2076,2101,2103,2088,2103,2108,2114,2110,2106,2105,2108,2106,29,3,13.705403869937406,0
2076,2081,2076,2101,2103,2088,2103,2108,2114,2110,2106,2105,2108,2106,2104,28,-4,12.549710677750229,0
2081,2076,2101,2103,2088,2103,2108,2114,2110,2106,2105,2108,2106,2104,2103,22,-11,10.78667608452117,0
2076,2101,2103,2088,2103,2108,2114,2110,2106,2105,2108,2106,2104,2103,2100,24,-10,9.271050693011064,0
2101,2103,2088,2103,2108,2114,2110,2106,2105,2108,2106,2104,2103,2100,2098,-3,-8,5.954590066255011,0
2103,2088,2103,2108,2114,2110,2106,2105,2108,2106,2104,2103,2100,2098,2091,-12,-14,6.791451208969224,0
2088,2103,2108,2114,2110,2106,2105,2108,2106,2104,2103,2100,2098,2091,2094,6,-14,7.189940062005948,0
2103,2108,2114,2110,2106,2105,2108,2106,2104,2103,2100,2098,2091,2094,2093,-10,-13,6.555985996091845,0
2108,2114,2110,2106,2105,2108,2106,2104,2103,2100,2098,2091,2094,2093,2100,-8,-4,6.597257727556922,0
2114,2110,2106,2105,2108,2106,2104,2103,2100,2098,2091,2094,2093,2100,2101,-13,-2,6.43872214473826,0
2110,2106,2105,2108,2106,2104,2103,2100,2098,2091,2094,2093,2100,2101,2101,-9,1,5.5506327395643655,0
2106,2105,2108,2106,2104,2103,2100,2098,2091,2094,2093,2100,2101,2101,2105,-1,7,5.1269595556932455,0
2105,2108,2106,2104,2103,2100,2098,2091,2094,2093,2100,2101,2101,2105,2105,0,14,5.06340747304572,0
2108,2106,2104,2103,2100,2098,2091,2094,2093,2100,2101,2101,2105,2105,2102,-6,8,4.949266419908923,0
2106,2104,2103,2100,2098,2091,2094,2093,2100,2101,2101,2105,2105,2102,2101,-5,8,4.527166674117278,0
2104,2103,2100,2098,2091,2094,2093,2100,2101,2101,2105,2105,2102,2101,2098,-6,-2,4.267261863247182,0
2103,2100,2098,2091,2094,2093,2100,2101,2101,2105,2105,2102,2101,2098,2098,-5,-3,4.117326918327103,0
2100,2098,2091,2094,2093,2100,2101,2101,2105,2105,2102,2101,2098,2098,2099,-1,-2,3.990464825532174,0
2098,2091,2094,2093,2100,2101,2101,2105,2105,2102,2101,2098,2098,2099,2100,2,-5,3.990464825532174,0
2091,2094,2093,2100,2101,2101,2105,2105,2102,2101,2098,2098,2099,2100,2106,15,1,4.355620342893602,0
2094,2093,2100,2101,2101,2105,2105,2102,2101,2098,2098,2099,2100,2106,2108,14,6,4.1656189158852435,0
2093,2100,2101,2101,2105,2105,2102,2101,2098,2098,2099,2100,2106,2108,2107,14,6,4.014260294784796,0
2100,2101,2101,2105,2105,2102,2101,2098,2098,2099,2100,2106,2108,2107,2108,8,10,3.561701038227982,0
2101,2101,2105,2105,2102,2101,2098,2098,2099,2100,2106,2108,2107,2108,2108,7,10,3.739111175259754,0
2101,2105,2105,2102,2101,2098,2098,2099,2100,2106,2108,2107,2108,2108,2101,0,2,3.739111175259754,0
2105,2105,2102,2101,2098,2098,2099,2100,2106,2108,2107,2108,2108,2101,2099,-6,-1,3.854496446637726,0
2105,2102,2101,2098,2098,2099,2100,2106,2108,2107,2108,2108,2101,2099,2099,-6,-7,3.9424430424366492,0
2102,2101,2098,2098,2099,2100,2106,2108,2107,2108,2108,2101,2099,2099,2102,0,-6,3.8877095717511763,0
2101,2098,2098,2099,2100,2106,2108,2107,2108,2108,2101,2099,2099,2102,2105,4,-2,3.9424430424366492,0
2098,2098,2099,2100,2106,2108,2107,2108,2108,2101,2099,2099,2102,2105,2107,9,-1,4.0708019567928595,0
2098,2099,2100,2106,2108,2107,2108,2108,2101,2099,2099,2102,2105,2107,2109,11,1,4.0964560757992245,0
2099,2100,2106,2108,2107,2108,2108,2101,2099,2099,2102,2105,2107,2109,2109,10,8,3.9797104465143236,0
2100,2106,2108,2107,2108,2108,2101,2099,2099,2102,2105,2107,2109,2109,2110,10,11,3.913347124174613,0
2106,2108,2107,2108,2108,2101,2099,2099,2102,2105,2107,2109,2109,2110,2108,2,9,3.6929791819200983,0
2108,2107,2108,2108,2101,2099,2099,2102,2105,2107,2109,2109,2110,2108,2105,-3,3,3.6968455021364726,0
2107,2108,2108,2101,2099,2099,2102,2105,2107,2109,2109,2110,2108,2105,2101,-6,-4,3.82099463490856,0
2108,2108,2101,2099,2099,2102,2105,2107,2109,2109,2110,2108,2105,2101,2101,-7,-6,3.9315573068623655,0
2108,2101,2099,2099,2102,2105,2107,2109,2109,2110,2108,2105,2101,2101,2101,-7,-8,3.94002658922621,0
2101,2099,2099,2102,2105,2107,2109,2109,2110,2108,2105,2101,2101,2101,2103,2,-6,3.8172540616821107,0
2099,2099,2102,2105,2107,2109,2109,2110,2108,2105,2101,2101,2101,2103,2107,8,-3,3.794733192202055,0
2099,2102,2105,2107,2109,2109,2110,2108,2105,2101,2101,2101,2103,2107,2108,9,0,3.585685828003181,0
2102,2105,2107,2109,2109,2110,2108,2105,2101,2101,2101,2103,2107,2108,2109,7,4,3.3094381626464866,0
2105,2107,2109,2109,2110,2108,2105,2101,2101,2101,2103,2107,2108,2109,2111,6,10,3.411465262624733,0
2107,2109,2109,2110,2108,2105,2101,2101,2101,2103,2107,2108,2109,2111,2108,1,7,3.41983012666391,0
2109,2109,2110,2108,2105,2101,2101,2101,2103,2107,2108,2109,2111,2108,2105,-4,4,3.4364987719368982,0
2109,2110,2108,2105,2101,2101,2101,2103,2107,2108,2109,2111,2108,2105,2102,-7,-1,3.5227154028566954,0
2110,2108,2105,2101,2101,2101,2103,2107,2108,2109,2111,2108,2105,2102,2101,-9,-6,3.61873432227873,0
2108,2105,2101,2101,2101,2103,2107,2108,2109,2111,2108,2105,2102,2101,2102,-6,-6,3.468223093829379,0
2105,2101,2101,2101,2103,2107,2108,2109,2111,2108,2105,2102,2101,2102,2101,-4,-8,3.4778208831448025,0
2101,2101,2101,2103,2107,2108,2109,2111,2108,2105,2102,2101,2102,2101,2107,6,-4,3.542933946940156,0
2101,2101,2103,2107,2108,2109,2111,2108,2105,2102,2101,2102,2101,2107,2110,9,2,3.6735865438612025,0
2101,2103,2107,2108,2109,2111,2108,2105,2102,2101,2102,2101,2107,2110,2110,9,5,3.6968455021364726,0
2103,2107,2108,2109,2111,2108,2105,2102,2101,2102,2101,2107,2110,2110,2109,6,7,3.5496478698597698,0
2107,2108,2109,2111,2108,2105,2102,2101,2102,2101,2107,2110,2110,2109,2105,-2,4,3.4572215654165053,0
2108,2109,2111,2108,2105,2102,2101,2102,2101,2107,2110,2110,2109,2105,2104,-4,2,3.5023801430836525,0
2109,2111,2108,2105,2102,2101,2102,2101,2107,2110,2110,2109,2105,2104,2099,-10,-2,3.907258203224694,0
2111,2108,2105,2102,2101,2102,2101,2107,2110,2110,2109,2105,2104,2099,2100,-11,-7,4.026105290417006,0
2108,2105,2102,2101,2102,2101,2107,2110,2110,2109,2105,2104,2099,2100,2097,-11,-13,4.140393356054125,0
2105,2102,2101,2102,2101,2107,2110,2110,2109,2105,2104,2099,2100,2097,2101,-4,-9,4.050867044167681,0
2102,2101,2102,2101,2107,2110,2110,2109,2105,2104,2099,2100,2097,2101,2105,3,-4,4.050867044167681,0
2101,2102,2101,2107,2110,2110,2109,2105,2104,2099,2100,2097,2101,2105,2108,7,3,4.182730937466346,0
2102,2101,2107,2110,2110,2109,2105,2104,2099,2100,2097,2101,2105,2108,2110,8,6,4.3730778090275875,0
2101,2107,2110,2110,2109,2105,2104,2099,2100,2097,2101,2105,2108,2110,2111,10,12,4.611579628139003,0
2107,2110,2110,2109,2105,2104,2099,2100,2097,2101,2105,2108,2110,2111,2110,3,10,4.6208636587093705,0
2110,2110,2109,2105,2104,2099,2100,2097,2101,2105,2108,2110,2111,2110,2106,-4,9,4.6084807950229365,0
2110,2109,2105,2104,2099,2100,2097,2101,2105,2108,2110,2111,2110,2106,2104,-6,3,4.463609472591607,0
2109,2105,2104,2099,2100,2097,2101,2105,2108,2110,2111,2110,2106,2104,2102,-7,-3,4.333699618219101,0
2105,2104,2099,2100,2097,2101,2105,2108,2110,2111,2110,2106,2104,2102,2099,-6,-9,4.399134113934349,0
2104,2099,2100,2097,2101,2105,2108,2110,2111,2110,2106,2104,2102,2099,2102,-2,-8,4.421807430495018,0
2099,2100,2097,2101,2105,2108,2110,2111,2110,2106,2104,2102,2099,2102,2106,7,-5,4.456135417280635,0
2100,2097,2101,2105,2108,2110,2111,2110,2106,2104,2102,2099,2102,2106,2108,8,-2,4.339190181194116,0
2097,2101,2105,2108,2110,2111,2110,2106,2104,2102,2099,2102,2106,2108,2110,13,4,4.350150517374028,0
2101,2105,2108,2110,2111,2110,2106,2104,2102,2099,2102,2106,2108,2110,2109,8,5,3.7884536360342267,0
2105,2108,2110,2111,2110,2106,2104,2102,2099,2102,2106,2108,2110,2109,2107,2,5,3.5227154028566954,0
2108,2110,2111,2110,2106,2104,2102,2099,2102,2106,2108,2110,2109,2107,2106,-2,7,3.5023801430836525,0
2110,2111,2110,2106,2104,2102,2099,2102,2106,2108,2110,2109,2107,2106,2104,-6,2,3.5348604067541474,0
2111,2110,2106,2104,2102,2099,2102,2106,2108,2110,2109,2107,2106,2104,2101,-10,-5,3.6187343222787294,0
2110,2106,2104,2102,2099,2102,2106,2108,2110,2109,2107,2106,2104,2101,2100,-10,-8,3.575045787252575,0
2106,2104,2102,2099,2102,2106,2108,2110,2109,2107,2106,2104,2101,2100,2103,-3,-7,3.313752009573496,0
2104,2102,2099,2102,2106,2108,2110,2109,2107,2106,2104,2101,2100,2103,2106,2,-3,3.313752009573496,0
2102,2099,2102,2106,2108,2110,2109,2107,2106,2104,2101,2100,2103,2106,2109,7,2,3.5091716564291513,0
2099,2102,2106,2108,2110,2109,2107,2106,2104,2101,2100,2103,2106,2109,2110,11,4,3.657998411830216,0
2102,2106,2108,2110,2109,2107,2106,2104,2101,2100,2103,2106,2109,2110,2109,7,5,3.3166247903554,0
2106,2108,2110,2109,2107,2106,2104,2101,2100,2103,2106,2109,2110,2109,2105,-1,4,3.1441555759399513,0
2108,2110,2109,2107,2106,2104,2101,2100,2103,2106,2109,2110,2109,2105,2103,-5,3,3.251373336211726,0
2110,2109,2107,2106,2104,2101,2100,2103,2106,2109,2110,2109,2105,2103,2102,-8,-1,3.3551665915633544,0
2109,2107,2106,2104,2101,2100,2103,2106,2109,2110,2109,2105,2103,2102,2101,-8,-5,3.3166247903554,0
2107,2106,2104,2101,2100,2103,2106,2109,2110,2109,2105,2103,2102,2101,2101,-6,-8,3.27035748737628,0
2106,2104,2101,2100,2103,2106,2109,2110,2109,2105,2103,2102,2101,2101,2102,-4,-8,3.24844285041017,0
2104,2101,2100,2103,2106,2109,2110,2109,2105,2103,2102,2101,2101,2102,2104,0,-5,3.2071349029490928,0
2101,2100,2103,2106,2109,2110,2109,2105,2103,2102,2101,2101,2102,2104,2108,7,3,3.369329451445933,0
2100,2103,2106,2109,2110,2109,2105,2103,2102,2101,2101,2102,2104,2108,2109,9,6,3.4475664294853385,0
2103,2106,2109,2110,2109,2105,2103,2102,2101,2101,2102,2104,2108,2109,2111,8,9,3.5227154028566954,0
2106,2109,2110,2109,2105,2103,2102,2101,2101,2102,2104,2108,2109,2111,2107,1,6,3.468223093829379,0
2109,2110,2109,2105,2103,2102,2101,2101,2102,2104,2108,2109,2111,2107,2106,-3,5,3.468223093829379,0
2110,2109,2105,2103,2102,2101,2101,2102,2104,2108,2109,2111,2107,2106,2103,-7,1,3.418437404094784,0
2109,2105,2103,2102,2101,2101,2102,2104,2108,2109,2111,2107,2106,2103,2101,-8,-3,3.3423687066852112,0
2105,2103,2102,2101,2101,2102,2104,2108,2109,2111,2107,2106,2103,2101,2100,-5,-8,3.3423687066852112,0
2103,2102,2101,2101,2102,2104,2108,2109,2111,2107,2106,2103,2101,2100,2100,-3,-9,3.5023801430836525,0
2102,2101,2101,2102,2104,2108,2109,2111,2107,2106,2103,2101,2100,2100,2105,3,-6,3.5050983275386565,0
2101,2101,2102,2104,2108,2109,2111,2107,2106,2103,2101,2100,2100,2105,2107,6,0,3.5388994791897557,0
2101,2102,2104,2108,2109,2111,2107,2106,2103,2101,2100,2100,2105,2107,2108,7,2,3.5294677866702306,0
2102,2104,2108,2109,2111,2107,2106,2103,2101,2100,2100,2105,2107,2108,2111,9,8,3.700707783010987,0
2104,2108,2109,2111,2107,2106,2103,2101,2100,2100,2105,2107,2108,2111,2108,4,7,3.6226798814978842,0
2108,2109,2111,2107,2106,2103,2101,2100,2100,2105,2107,2108,2111,2108,2105,-3,5,3.594970031002974,0
2109,2111,2107,2106,2103,2101,2100,2100,2105,2107,2108,2111,2108,2105,2101,-8,1,3.7581657126595047,0
2111,2107,2106,2103,2101,2100,2100,2105,2107,2108,2111,2108,2105,2101,2102,-9,-3,3.722518348798681,0
2107,2106,2103,2101,2100,2100,2105,2107,2108,2111,2108,2105,2101,2102,2097,-10,-10,3.863134675857098,0
2106,2103,2101,2100,2100,2105,2107,2108,2111,2108,2105,2101,2102,2097,2101,-5,-7,3.8483144114694956,0
2103,2101,2100,2100,2105,2107,2108,2111,2108,2105,2101,2102,2097,2101,2102,-1,-9,3.813509819425819,0
2101,2100,2100,2105,2107,2108,2111,2108,2105,2101,2102,2097,2101,2102,2105,4,-3,3.833436851604327,0
2100,2100,2105,2107,2108,2111,2108,2105,2101,2102,2097,2101,2102,2105,2109,9,4,4.00832467081531,0
2100,2105,2107,2108,2111,2108,2105,2101,2102,2097,2101,2102,2105,2109,2110,10,9,4.113855797644045,0
2105,2107,2108,2111,2108,2105,2101,2102,2097,2101,2102,2105,2109,2110,2107,2,5,3.9315573068623655,0
2107,2108,2111,2108,2105,2101,2102,2097,2101,2102,2105,2109,2110,2107,2106,-1,9,3.936399128040511,0
2108,2111,2108,2105,2101,2102,2097,2101,2102,2105,2109,2110,2107,2106,2102,-6,1,3.990464825532174,0
2111,2108,2105,2101,2102,2097,2101,2102,2105,2109,2110,2107,2106,2102,2101,-10,-1,4.015446366695678,0
2108,2105,2101,2102,2097,2101,2102,2105,2109,2110,2107,2106,2102,2101,2099,-9,-6,3.8110116142317807,0
2105,2101,2102,2097,2101,2102,2105,2109,2110,2107,2106,2102,2101,2099,2099,-6,-10,3.7884536360342267,0
2101,2102,2097,2101,2102,2105,2109,2110,2107,2106,2102,2101,2099,2099,2101,0,-9,3.783422486887463,0
2102,2097,2101,2102,2105,2109,2110,2107,2106,2102,2101,2099,2099,2101,2106,4,-1,3.833436851604327,0
2097,2101,2102,2105,2109,2110,2107,2106,2102,2101,2099,2099,2101,2106,2108,11,2,4.015446366695678,0
2101,2102,2105,2109,2110,2107,2106,2102,2101,2099,2099,2101,2106,2108,2108,7,6,3.731462116089285,0
2102,2105,2109,2110,2107,2106,2102,2101,2099,2099,2101,2106,2108,2108,2108,6,7,3.731462116089285,0
2105,2109,2110,2107,2106,2102,2101,2099,2099,2101,2106,2108,2108,2108,2107,2,8,3.6929791819200983,0
2109,2110,2107,2106,2102,2101,2099,2099,2101,2106,2108,2108,2108,2107,2104,-5,5,3.7032803990902057,0
2110,2107,2106,2102,2101,2099,2099,2101,2106,2108,2108,2108,2107,2104,2102,-8,1,3.602908877692077,0
2107,2106,2102,2101,2099,2099,2101,2106,2108,2108,2108,2107,2104,2102,2102,-5,-4,3.3166247903554,0
2106,2102,2101,2099,2099,2101,2106,2108,2108,2108,2107,2104,2102,2102,2102,-4,-6,3.2440421581430665,0
2102,2101,2099,2099,2101,2106,2108,2108,2108,2107,2104,2102,2102,2102,2104,2,-4,3.1817934445544265,0
2101,2099,2099,2101,2106,2108,2108,2108,2107,2104,2102,2102,2102,2104,2107,6,-1,3.27035748737628,0
2099,2099,2101,2106,2108,2108,2108,2107,2104,2102,2102,2102,2104,2107,2113,14,6,3.9218557317872342,0
2099,2101,2106,2108,2108,2108,2107,2104,2102,2102,2102,2104,2107,2113,2114,15,10,4.270608298368657,0
2101,2106,2108,2108,2108,2107,2104,2102,2102,2102,2104,2107,2113,2114,2114,13,12,4.353433237386437,0
2106,2108,2108,2108,2107,2104,2102,2102,2102,2104,2107,2113,2114,2114,2117,11,15,4.802776974487434,0
2108,2108,2108,2107,2104,2102,2102,2102,2104,2107,2113,2114,2114,2117,2118,10,16,5.449333729479054,0
2108,2108,2107,2104,2102,2102,2102,2104,2107,2113,2114,2114,2117,2118,2118,10,14,5.966573556070519,0
2108,2107,2104,2102,2102,2102,2104,2107,2113,2114,2114,2117,2118,2118,2116,8,9,6.204453085908386,0
2107,2104,2102,2102,2102,2104,2107,2113,2114,2114,2117,2118,2118,2116,2118,11,5,6.5334305143404015,0
2104,2102,2102,2102,2104,2107,2113,2114,2114,2117,2118,2118,2116,2118,2122,18,8,7.0992957397195395,1
2102,2102,2102,2104,2107,2113,2114,2114,2117,2118,2118,2116,2118,2122,2123,21,9,7.374344200059581,1
2102,2102,2104,2107,2113,2114,2114,2117,2118,2118,2116,2118,2122,2123,2126,24,9,7.497301101698118,1
2102,2104,2107,2113,2114,2114,2117,2118,2118,2116,2118,2122,2123,2126,2130,28,12,7.707757378740188,1
2104,2107,2113,2114,2114,2117,2118,2118,2116,2118,2122,2123,2126,2130,2130,26,12,7.4258236676383005,1
2107,2113,2114,2114,2117,2118,2118,2116,2118,2122,2123,2126,2130,2130,2127,20,11,6.66404710438963,1
2113,2114,2114,2117,2118,2118,2116,2118,2122,2123,2126,2130,2130,2127,2127,14,9,5.938574464184706,1
2114,2114,2117,2118,2118,2116,2118,2122,2123,2126,2130,2130,2127,2127,2126,12,4,5.650115885874335,1
2114,2117,2118,2118,2116,2118,2122,2123,2126,2130,2130,2127,2127,2126,2123,9,0,5.2326811847228365,1
2117,2118,2118,2116,2118,2122,2123,2126,2130,2130,2127,2127,2126,2123,2125,8,-1,4.727830469928142,1
2118,2118,2116,2118,2122,2123,2126,2130,2130,2127,2127,2126,2123,2125,2127,9,-3,4.511361319200774,1
2118,2116,2118,2122,2123,2126,2130,2130,2127,2127,2126,2123,2125,2127,2125,7,-5,4.229150539495406,1
2116,2118,2122,2123,2126,2130,2130,2127,2127,2126,2123,2125,2127,2125,2121,5,-6,3.978513721048531,1
2118,2122,2123,2126,2130,2130,2127,2127,2126,2123,2125,2127,2125,2121,2119,1,-8,3.5816995167896803,1
2122,2123,2126,2130,2130,2127,2127,2126,2123,2125,2127,2125,2121,2119,2105,-17,-21,6.029293569928483,1
2123,2126,2130,2130,2127,2127,2126,2123,2125,2127,2125,2121,2119,2105,2099,-24,-24,8.792854241614933,1
2126,2130,2130,2127,2127,2126,2123,2125,2127,2125,2121,2119,2105,2099,2052,-74,-73,20.131236093858387,1
2130,2130,2127,2127,2126,2123,2125,2127,2125,2121,2119,2105,2099,2052,2041,-89,-86,27.987752423413454,1
2130,2127,2127,2126,2123,2125,2127,2125,2121,2119,2105,2099,2052,2041,2088,-42,-37,28.13741789351478,1
2127,2127,2126,2123,2125,2127,2125,2121,2119,2105,2099,2052,2041,2088,2096,-31,-25,27.690809890303903,1
2127,2126,2123,2125,2127,2125,2121,2119,2105,2099,2052,2041,2088,2096,2103,-24,-16,27.123702514502664,1
2126,2123,2125,2127,2125,2121,2119,2105,2099,2052,2041,2088,2096,2103,2246,120,141,45.29343482332995,1
2123,2125,2127,2125,2121,2119,2105,2099,2052,2041,2088,2096,2103,2246,2258,135,159,58.796096404276305,1
2125,2127,2125,2121,2119,2105,2099,2052,2041,2088,2096,2103,2246,2258,2268,143,216,69.87219625519016,1
2127,2125,2121,2119,2105,2099,2052,2041,2088,2096,2103,2246,2258,2268,2265,138,224,77.83395023717998,1
2125,2121,2119,2105,2099,2052,2041,2088,2096,2103,2246,2258,2268,2265,2270,145,182,84.4873616922335,1
2121,2119,2105,2099,2052,2041,2088,2096,2103,2246,2258,2268,2265,2270,2269,148,173,89.43153806124549,1
2119,2105,2099,2052,2041,2088,2096,2103,2246,2258,2268,2265,2270,2269,2253,134,150,91.78328512627682,1
2105,2099,2052,2041,2088,2096,2103,2246,2258,2268,2265,2270,2269,2253,2245,140,-1,92.66159629842035,1
2099,2052,2041,2088,2096,2103,2246,2258,2268,2265,2270,2269,2253,2245,2240,141,-18,91.6991976908351,1
2052,2041,2088,2096,2103,2246,2258,2268,2265,2270,2269,2253,2245,2240,2256,204,-12,89.97909810193751,0
2041,2088,2096,2103,2246,2258,2268,2265,2270,2269,2253,2245,2240,2256,2243,202,-22,81.12318675059203,0
2088,2096,2103,2246,2258,2268,2265,2270,2269,2253,2245,2240,2256,2243,2248,160,-22,66.76633026565753,0
2096,2103,2246,2258,2268,2265,2270,2269,2253,2245,2240,2256,2243,2248,2225,129,-44,55.34394619967373,0
2103,2246,2258,2268,2265,2270,2269,2253,2245,2240,2256,2243,2248,2225,2239,136,-14,40.51078633554043,0
2246,2258,2268,2265,2270,2269,2253,2245,2240,2256,2243,2248,2225,2239,2230,-16,-15,14.03397238676138,0
2258,2268,2265,2270,2269,2253,2245,2240,2256,2243,2248,2225,2239,2230,2231,-27,-9,14.874074601066624,0
2268,2265,2270,2269,2253,2245,2240,2256,2243,2248,2225,2239,2230,2231,2242,-26,-14,14.78158442438557,0
2265,2270,2269,2253,2245,2240,2256,2243,2248,2225,2239,2230,2231,2242,2218,-47,-25,15.627204606375505,0
2270,2269,2253,2245,2240,2256,2243,2248,2225,2239,2230,2231,2242,2218,2232,-38,-16,14.906693926203886,0
2269,2253,2245,2240,2256,2243,2248,2225,2239,2230,2231,2242,2218,2232,2207,-62,-18,15.537358971508763,0
2253,2245,2240,2256,2243,2248,2225,2239,2230,2231,2242,2218,2232,2207,2204,-49,-35,15.497465230528139,0
2245,2240,2256,2243,2248,2225,2239,2230,2231,2242,2218,2232,2207,2204,2129,-116,-101,30.532106442391488,0
2240,2256,2243,2248,2225,2239,2230,2231,2242,2218,2232,2207,2204,2129,2196,-44,-35,30.96464958318637,0
2256,2243,2248,2225,2239,2230,2231,2242,2218,2232,2207,2204,2129,2196,2172,-84,-70,33.14657204139273,0
2243,2248,2225,2239,2230,2231,2242,2218,2232,2207,2204,2129,2196,2172,2164,-79,-54,34.13628149470463,0
2248,2225,2239,2230,2231,2242,2218,2232,2207,2204,2129,2196,2172,2164,2270,22,38,36.516532459382596,0
2225,2239,2230,2231,2242,2218,2232,2207,2204,2129,2196,2172,2164,2270,2239,14,32,35.984520481530865,0
2239,2230,2231,2242,2218,2232,2207,2204,2129,2196,2172,2164,2270,2239,2229,-10,25,36.092869629543706,0
2230,2231,2242,2218,2232,2207,2204,2129,2196,2172,2164,2270,2239,2229,2232,2,103,35.78307660652688,0
2231,2242,2218,2232,2207,2204,2129,2196,2172,2164,2270,2239,2229,2232,2209,-22,13,35.47997423094571,0
2242,2218,2232,2207,2204,2129,2196,2172,2164,2270,2239,2229,2232,2209,2194,-48,22,35.320707537539235,0
2218,2232,2207,2204,2129,2196,2172,2164,2270,2239,2229,2232,2209,2194,2208,-10,44,34.131817302642304,0
2232,2207,2204,2129,2196,2172,2164,2270,2239,2229,2232,2209,2194,2208,2223,-9,-47,34.27243790569909,0
2207,2204,2129,2196,2172,2164,2270,2239,2229,2232,2209,2194,2208,2223,2204,-3,-35,33.58074845304474,0
2204,2129,2196,2172,2164,2270,2239,2229,2232,2209,2194,2208,2223,2204,2232,28,3,34.28244031987388,0
2129,2196,2172,2164,2270,2239,2229,2232,2209,2194,2208,2223,2204,2232,2222,93,-10,34.48436498721455,0
2196,2172,2164,2270,2239,2229,2232,2209,2194,2208,2223,2204,2232,2222,2184,-12,-25,27.722777295075993,0
2172,2164,2270,2239,2229,2232,2209,2194,2208,2223,2204,2232,2222,2184,2217,45,23,27.392560686295486,0
2164,2270,2239,2229,2232,2209,2194,2208,2223,2204,2232,2222,2184,2217,2225,61,17,25.003428336358766,0
2270,2239,2229,2232,2209,2194,2208,2223,2204,2232,2222,2184,2217,2225,2219,-51,-4,20.297313920343065,0
2239,2229,2232,2209,2194,2208,2223,2204,2232,2222,2184,2217,2225,2219,2221,-18,17,15.010472534676772,0
2229,2232,2209,2194,2208,2223,2204,2232,2222,2184,2217,2225,2219,2221,2227,-2,-5,14.054994028559996,0
2232,2209,2194,2208,2223,2204,2232,2222,2184,2217,2225,2219,2221,2227,2219,-13,-3,13.645861050498931,0
2209,2194,2208,2223,2204,2232,2222,2184,2217,2225,2219,2221,2227,2219,2219,10,35,12.933161510886139,0
2194,2208,2223,2204,2232,2222,2184,2217,2225,2219,2221,2227,2219,2219,2198,4,-19,13.58500573987295,0
2208,2223,2204,2232,2222,2184,2217,2225,2219,2221,2227,2219,2219,2198,2217,9,-8,12.396235987858034,0
2223,2204,2232,2222,2184,2217,2225,2219,2221,2227,2219,2219,2198,2217,2227,4,8,12.526923386203395,0
2204,2232,2222,2184,2217,2225,2219,2221,2227,2219,2219,2198,2217,2227,2212,8,-9,12.468245380050188,0
2232,2222,2184,2217,2225,2219,2221,2227,2219,2219,2198,2217,2227,2212,2185,-47,-42,14.58211559541671,0
2222,2184,2217,2225,2219,2221,2227,2219,2219,2198,2217,2227,2212,2185,2226,4,7,14.15660707265423,0
2184,2217,2225,2219,2221,2227,2219,2219,2198,2217,2227,2212,2185,2226,2224,40,5,14.24112087616434,0
2217,2225,2219,2221,2227,2219,2219,2198,2217,2227,2212,2185,2226,2224,2217,0,19,11.438448113188048,0
2225,2219,2221,2227,2219,2219,2198,2217,2227,2212,2185,2226,2224,2217,2209,-16,-8,11.616900660347447,0
2219,2221,2227,2219,2219,2198,2217,2227,2212,2185,2226,2224,2217,2209,2218,-1,-9,11.382107930975746,0
2221,2227,2219,2219,2198,2217,2227,2212,2185,2226,2224,2217,2209,2218,2239,18,27,12.851903694450428,0
2227,2219,2219,2198,2217,2227,2212,2185,2226,2224,2217,2209,2218,2239,2203,-24,18,13.30413469565007,0
2219,2219,2198,2217,2227,2212,2185,2226,2224,2217,2209,2218,2239,2203,2205,-14,-21,13.217232618639883,0
2219,2198,2217,2227,2212,2185,2226,2224,2217,2209,2218,2239,2203,2205,2207,-12,-17,13.290526522229857,0
2198,2217,2227,2212,2185,2226,2224,2217,2209,2218,2239,2203,2205,2207,2221,23,4,13.357002800386164,0
2217,2227,2212,2185,2226,2224,2217,2209,2218,2239,2203,2205,2207,2221,2209,-8,0,12.709951107020716,0
2227,2212,2185,2226,2224,2217,2209,2218,2239,2203,2205,2207,2221,2209,2214,-13,-4,12.693080229569405,0
2212,2185,2226,2224,2217,2209,2218,2239,2203,2205,2207,2221,2209,2214,2203,-9,-36,12.502571164136029,0
2185,2226,2224,2217,2209,2218,2239,2203,2205,2207,2221,2209,2214,2203,2215,30,12,12.51285053740468,0
2226,2224,2217,2209,2218,2239,2203,2205,2207,2221,2209,2214,2203,2215,2212,-14,7,9.857556927120866,0
2224,2217,2209,2218,2239,2203,2205,2207,2221,2209,2214,2203,2215,2212,2226,2,19,9.857556927120866,0
2217,2209,2218,2239,2203,2205,2207,2221,2209,2214,2203,2215,2212,2226,2212,-5,-9,9.539392014169456,0
2209,2218,2239,2203,2205,2207,2221,2209,2214,2203,2215,2212,2226,2212,2206,-3,-3,9.713515375618703,0
2218,2239,2203,2205,2207,2221,2209,2214,2203,2215,2212,2226,2212,2206,2211,-7,-3,9.664367542679656,0
2239,2203,2205,2207,2221,2209,2214,2203,2215,2212,2226,2212,2206,2211,2226,-13,23,10.14513723533642,0
2203,2205,2207,2221,2209,2214,2203,2215,2212,2226,2212,2206,2211,2226,2218,15,3,7.558029473600214,0
2205,2207,2221,2209,2214,2203,2215,2212,2226,2212,2206,2211,2226,2218,2200,-5,-12,7.861903319777204,0
2207,2221,2209,2214,2203,2215,2212,2226,2212,2206,2211,2226,2218,2200,2228,21,2,8.542888995003528,0
2221,2209,2214,2203,2215,2212,2226,2212,2206,2211,2226,2218,2200,2228,2206,-15,-6,8.603985787329696,0
2209,2214,2203,2215,2212,2226,2212,2206,2211,2226,2218,2200,2228,2206,2221,12,15,8.603985787329696,0
2214,2203,2215,2212,2226,2212,2206,2211,2226,2218,2200,2228,2206,2221,2227,13,16,9.126100716391107,0
2203,2215,2212,2226,2212,2206,2211,2226,2218,2200,2228,2206,2221,2227,2204,1,-22,9.559338490761396,0
2215,2212,2226,2212,2206,2211,2226,2218,2200,2228,2206,2221,2227,2204,2191,-24,-27,10.9731273486424,0
2212,2226,2212,2206,2211,2226,2218,2200,2228,2206,2221,2227,2204,2191,2216,4,16,10.985704997209522,0
2226,2212,2206,2211,2226,2218,2200,2228,2206,2221,2227,2204,2191,2216,2224,-2,-4,11.293487377371843,0
2212,2206,2211,2226,2218,2200,2228,2206,2221,2227,2204,2191,2216,2224,2194,-18,-12,11.949098391968842,0
2206,2211,2226,2218,2200,2228,2206,2221,2227,2204,2191,2216,2224,2194,2223,17,2,12.264932589646444,0
2211,2226,2218,2200,2228,2206,2221,2227,2204,2191,2216,2224,2194,2223,2231,20,4,12.926532330646069,0
2226,2218,2200,2228,2206,2221,2227,2204,2191,2216,2224,2194,2223,2231,2229,3,25,13.389050252600693,0
2218,2200,2228,2206,2221,2227,2204,2191,2216,2224,2194,2223,2231,2229,2201,-17,10,13.592014462281046,0
2200,2228,2206,2221,2227,2204,2191,2216,2224,2194,2223,2231,2229,2201,2224,24,8,13.798550648528272,0
2228,2206,2221,2227,2204,2191,2216,2224,2194,2223,2231,2229,2201,2224,2221,-7,-3,13.2664991614216,0
2206,2221,2227,2204,2191,2216,2224,2194,2223,2231,2229,2201,2224,2221,2203,-3,9,13.221555271961154,0
2221,2227,2204,2191,2216,2224,2194,2223,2231,2229,2201,2224,2221,2203,2213,-8,-10,13.028540100212961,0
2227,2204,2191,2216,2224,2194,2223,2231,2229,2201,2224,2221,2203,2213,2202,-25,-29,13.30341882303013,0
2204,2191,2216,2224,2194,2223,2231,2229,2201,2224,2221,2203,2213,2202,2213,9,-16,12.77162032454323,0
2191,2216,2224,2194,2223,2231,2229,2201,2224,2221,2203,2213,2202,2213,2215,24,14,12.556538801224908,0
2216,2224,2194,2223,2231,2229,2201,2224,2221,2203,2213,2202,2213,2215,2191,-25,-33,12.556538801224908,0
2224,2194,2223,2231,2229,2201,2224,2221,2203,2213,2202,2213,2215,2191,2228,4,7,13.108703034171429,0
2194,2223,2231,2229,2201,2224,2221,2203,2213,2202,2213,2215,2191,2228,2212,18,9,12.826683496672455,0
2223,2231,2229,2201,2224,2221,2203,2213,2202,2213,2215,2191,2228,2212,2219,-4,6,11.710800875382398,0
2231,2229,2201,2224,2221,2203,2213,2202,2213,2215,2191,2228,2212,2219,2203,-28,1,11.872336794093274,0
2229,2201,2224,2221,2203,2213,2202,2213,2215,2191,2228,2212,2219,2203,2215,-14,2,10.881176406988354,0
2201,2224,2221,2203,2213,2202,2213,2215,2191,2228,2212,2219,2203,2215,2249,48,34,13.853656900754022,0
2224,2221,2203,2213,2202,2213,2215,2191,2228,2212,2219,2203,2215,2249,2222,-2,31,13.510137287378301,0
2221,2203,2213,2202,2213,2215,2191,2228,2212,2219,2203,2215,2249,2222,2221,0,-7,13.394384039944645,0
2203,2213,2202,2213,2215,2191,2228,2212,2219,2203,2215,2249,2222,2221,2235,32,23,14.29018977514028,0
2213,2202,2213,2215,2191,2228,2212,2219,2203,2215,2249,2222,2221,2235,2202,-11,-17,14.357675896288269,0
2202,2213,2215,2191,2228,2212,2219,2203,2215,2249,2222,2221,2235,2202,2237,35,34,15.30546121020673,0
2213,2215,2191,2228,2212,2219,2203,2215,2249,2222,2221,2235,2202,2237,2208,-5,-7,14.942747882692604,0
2215,2191,2228,2212,2219,2203,2215,2249,2222,2221,2235,2202,2237,2208,2223,8,-26,14.926805546047815,0
2191,2228,2212,2219,2203,2215,2249,2222,2221,2235,2202,2237,2208,2223,2247,56,25,16.56243598370378,0
2228,2212,2219,2203,2215,2249,2222,2221,2235,2202,2237,2208,2223,2247,2205,-23,-16,15.092413736077884,0
2212,2219,2203,2215,2249,2222,2221,2235,2202,2237,2208,2223,2247,2205,2201,-11,-34,15.88110587489183,0
2219,2203,2215,2249,2222,2221,2235,2202,2237,2208,2223,2247,2205,2201,2221,2,19,15.729256937615451,0
2203,2215,2249,2222,2221,2235,2202,2237,2208,2223,2247,2205,2201,2221,2225,22,-12,15.763731731263322,0
2215,2249,2222,2221,2235,2202,2237,2208,2223,2247,2205,2201,2221,2225,2207,-8,-1,15.469786220704076,0
2249,2222,2221,2235,2202,2237,2208,2223,2247,2205,2201,2221,2225,2207,2215,-34,-8,15.469786220704076,0
2222,2221,2235,2202,2237,2208,2223,2247,2205,2201,2221,2225,2207,2215,2206,-16,-41,13.849531537547536,0
2221,2235,2202,2237,2208,2223,2247,2205,2201,2221,2225,2207,2215,2206,2214,-7,9,13.852281916193963,0
2235,2202,2237,2208,2223,2247,2205,2201,2221,2225,2207,2215,2206,2214,2219,-16,18,13.828886261666021,0
2202,2237,2208,2223,2247,2205,2201,2221,2225,2207,2215,2206,2214,2219,2210,8,-11,13.076696830622021,0
2237,2208,2223,2247,2205,2201,2221,2225,2207,2215,2206,2214,2219,2210,2207,-30,-18,12.754084313139327,0
2208,2223,2247,2205,2201,2221,2225,2207,2215,2206,2214,2219,2210,2207,2218,10,11,11.429702324999337,0
2223,2247,2205,2201,2221,2225,2207,2215,2206,2214,2219,2210,2207,2218,2185,-38,-30,13.75222925651727,0
2247,2205,2201,2221,2225,2207,2215,2206,2214,2219,2210,2207,2218,2185,2194,-53,-12,14.351704727015134,0
2205,2201,2221,2225,2207,2215,2206,2214,2219,2210,2207,2218,2185,2194,2219,14,5,10.799911816218467,0
2201,2221,2225,2207,2215,2206,2214,2219,2210,2207,2218,2185,2194,2219,2196,-5,-23,11.31917883610863,0
2221,2225,2207,2215,2206,2214,2219,2210,2207,2218,2185,2194,2219,2196,2189,-32,-21,12.315302134607444,0
2225,2207,2215,2206,2214,2219,2210,2207,2218,2185,2194,2219,2196,2189,2209,-16,2,11.813229065432573,0
2207,2215,2206,2214,2219,2210,2207,2218,2185,2194,2219,2196,2189,2209,2224,17,6,11.709987597081797,0
2215,2206,2214,2219,2210,2207,2218,2185,2194,2219,2196,2189,2209,2224,2198,-17,13,11.963436359332945,0
2206,2214,2219,2210,2207,2218,2185,2194,2219,2196,2189,2209,2224,2198,2213,7,19,11.877148928369412,0
2214,2219,2210,2207,2218,2185,2194,2219,2196,2189,2209,2224,2198,2213,2218,4,-1,12.223318854121569,0
2219,2210,2207,2218,2185,2194,2219,2196,2189,2209,2224,2198,2213,2218,2211,-8,15,12.134170562428041,0
2210,2207,2218,2185,2194,2219,2196,2189,2209,2224,2198,2213,2218,2211,2198,-12,9,11.901180413643651,0
2207,2218,2185,2194,2219,2196,2189,2209,2224,2198,2213,2218,2211,2198,2211,4,2,11.92835756865606,0
2218,2185,2194,2219,2196,2189,2209,2224,2198,2213,2218,2211,2198,2211,2189,-29,-35,12.700956094494844,0
2185,2194,2219,2196,2189,2209,2224,2198,2213,2218,2211,2198,2211,2189,2222,37,24,13.035482711576488,0
2194,2219,2196,2189,2209,2224,2198,2213,2218,2211,2198,2211,2189,2222,2204,10,-9,11.812019705529174,0
2219,2196,2189,2209,2224,2198,2213,2218,2211,2198,2211,2189,2222,2204,2215,-4,-3,11.485809049597226,0
2196,2189,2209,2224,2198,2213,2218,2211,2198,2211,2189,2222,2204,2215,2218,22,7,11.4184478971948,0
2189,2209,2224,2198,2213,2218,2211,2198,2211,2189,2222,2204,2215,2218,2216,27,18,11.122692377040988,0
2209,2224,2198,2213,2218,2211,2198,2211,2189,2222,2204,2215,2218,2216,2199,-10,-12,10.090070555230216,0
2224,2198,2213,2218,2211,2198,2211,2189,2222,2204,2215,2218,2216,2199,2207,-17,18,10.112698288126007,0
2198,2213,2218,2211,2198,2211,2189,2222,2204,2215,2218,2216,2199,2207,2217,19,-5,9.542885657214313,0
2213,2218,2211,2198,2211,2189,2222,2204,2215,2218,2216,2199,2207,2217,2211,-2,7,9.043282168601861,0
2218,2211,2198,2211,2189,2222,2204,2215,2218,2216,2199,2207,2217,2211,2206,-12,-9,9.054333348234556,0
2211,2198,2211,2189,2222,2204,2215,2218,2216,2199,2207,2217,2211,2206,2229,18,11,10.171388442938499,0
2198,2211,2189,2222,2204,2215,2218,2216,2199,2207,2217,2211,2206,2229,2210,12,-6,10.169047340312847,0
2211,2189,2222,2204,2215,2218,2216,2199,2207,2217,2211,2206,2229,2210,2227,16,28,10.450336062037612,0
2189,2222,2204,2215,2218,2216,2199,2207,2217,2211,2206,2229,2210,2227,2225,36,18,10.96096971726759,0
2222,2204,2215,2218,2216,2199,2207,2217,2211,2206,2229,2210,2227,2225,2210,-12,-7,8.805842216554709,0
2204,2215,2218,2216,2199,2207,2217,2211,2206,2229,2210,2227,2225,2210,2222,18,11,8.805842216554709,0
2215,2218,2216,2199,2207,2217,2211,2206,2229,2210,2227,2225,2210,2222,2221,6,15,8.4588640462169,0
2218,2216,2199,2207,2217,2211,2206,2229,2210,2227,2225,2210,2222,2221,2205,-13,-24,8.887122840433364,0
2216,2199,2207,2217,2211,2206,2229,2210,2227,2225,2210,2222,2221,2205,2219,3,9,8.916010211705576,0
2199,2207,2217,2211,2206,2229,2210,2227,2225,2210,2222,2221,2205,2219,2236,37,9,10.450336062037614,0
2207,2217,2211,2206,2229,2210,2227,2225,2210,2222,2221,2205,2219,2236,2208,1,-17,9.612987246924018,0
2217,2211,2206,2229,2210,2227,2225,2210,2222,2221,2205,2219,2236,2208,2226,9,16,9.470756996947927,0
2211,2206,2229,2210,2227,2225,2210,2222,2221,2205,2219,2236,2208,2226,2205,-6,-17,10.06171432898466,0
2206,2229,2210,2227,2225,2210,2222,2221,2205,2219,2236,2208,2226,2205,2242,36,21,11.715679359607913,0
2229,2210,2227,2225,2210,2222,2221,2205,2219,2236,2208,2226,2205,2242,2207,-22,2,11.636559792718973,0
2210,2227,2225,2210,2222,2221,2205,2219,2236,2208,2226,2205,2242,2207,2237,27,18,12.270755012281379,0
2227,2225,2210,2222,2221,2205,2219,2236,2208,2226,2205,2242,2207,2237,2209,-18,-27,12.331531399897852,0
2225,2210,2222,2221,2205,2219,2236,2208,2226,2205,2242,2207,2237,2209,2218,-7,10,12.18117204463316,0
2210,2222,2221,2205,2219,2236,2208,2226,2205,2242,2207,2237,2209,2218,2217,7,-9,12.090137657257198,0
2222,2221,2205,2219,2236,2208,2226,2205,2242,2207,2237,2209,2218,2217,2247,25,42,13.817518211452066,0
2221,2205,2219,2236,2208,2226,2205,2242,2207,2237,2209,2218,2217,2247,2231,10,-11,14.045165241700314,0
2205,2219,2236,2208,2226,2205,2242,2207,2237,2209,2218,2217,2247,2231,2226,21,19,14.082410507945212,0
2219,2236,2208,2226,2205,2242,2207,2237,2209,2218,2217,2247,2231,2226,2220,1,-17,13.283717207812836,0
2236,2208,2226,2205,2242,2207,2237,2209,2218,2217,2247,2231,2226,2220,2227,-9,18,13.263627313966927,0
2208,2226,2205,2242,2207,2237,2209,2218,2217,2247,2231,2226,2220,2227,2228,20,10,12.890749728833796,0
2226,2205,2242,2207,2237,2209,2218,2217,2247,2231,2226,2220,2227,2228,2233,7,16,12.391625436252541,0
2205,2242,2207,2237,2209,2218,2217,2247,2231,2226,2220,2227,2228,2233,2220,15,-27,12.44913460369645,0
2242,2207,2237,2209,2218,2217,2247,2231,2226,2220,2227,2228,2233,2220,2209,-33,-22,12.03843052577077,0
2207,2237,2209,2218,2217,2247,2231,2226,2220,2227,2228,2233,2220,2209,2237,30,11,11.586938459193734,0
2237,2209,2218,2217,2247,2231,2226,2220,2227,2228,2233,2220,2209,2237,2202,-35,-18,12.17999921807801,0
2209,2218,2217,2247,2231,2226,2220,2227,2228,2233,2220,2209,2237,2202,2238,29,11,12.258330500792784,0
2218,2217,2247,2231,2226,2220,2227,2228,2233,2220,2209,2237,2202,2238,2231,13,3,11.617720455038869,0
2217,2247,2231,2226,2220,2227,2228,2233,2220,2209,2237,2202,2238,2231,2231,14,-2,11.494512148143109,0
2247,2231,2226,2220,2227,2228,2233,2220,2209,2237,2202,2238,2231,2231,2252,5,32,12.9018271131318,0
2231,2226,2220,2227,2228,2233,2220,2209,2237,2202,2238,2231,2231,2252,2070,-161,-139,42.36575436431107,0
2226,2220,2227,2228,2233,2220,2209,2237,2202,2238,2231,2231,2252,2070,2116,-110,-121,49.46234739196887,0
2220,2227,2228,2233,2220,2209,2237,2202,2238,2231,2231,2252,2070,2116,2108,-112,-94,55.622280564878814,0
2227,2228,2233,2220,2209,2237,2202,2238,2231,2231,2252,2070,2116,2108,2113,-114,-125,59.78134762456868,0
2228,2233,2220,2209,2237,2202,2238,2231,2231,2252,2070,2116,2108,2113,2111,-117,-120,62.68606589301052,0
2233,2220,2209,2237,2202,2238,2231,2231,2252,2070,2116,2108,2113,2111,2116,-117,-115,64.05786074955613,0
2220,2209,2237,2202,2238,2231,2231,2252,2070,2116,2108,2113,2111,2116,2116,-104,-136,64.1534618447568,0
2209,2237,2202,2238,2231,2231,2252,2070,2116,2108,2113,2111,2116,2116,2118,-91,48,64.03220915698449,0
2237,2202,2238,2231,2231,2252,2070,2116,2108,2113,2111,2116,2116,2118,2117,-120,1,63.87465403876117,0
2202,2238,2231,2231,2252,2070,2116,2108,2113,2111,2116,2116,2118,2117,2111,-91,3,61.02107364322123,0
2238,2231,2231,2252,2070,2116,2108,2113,2111,2116,2116,2118,2117,2111,2107,-131,-6,60.16247841905958,0
2231,2231,2252,2070,2116,2108,2113,2111,2116,2116,2118,2117,2111,2107,2104,-127,-7,54.87058367086095,0
2231,2252,2070,2116,2108,2113,2111,2116,2116,2118,2117,2111,2107,2104,2104,-127,-12,48.368328874328895,0
2252,2070,2116,2108,2113,2111,2116,2116,2118,2117,2111,2107,2104,2104,2100,-152,-16,39.032709116232006,0
2070,2116,2108,2113,2111,2116,2116,2118,2117,2111,2107,2104,2104,2100,2099,29,-19,12.045548476314314,0
2116,2108,2113,2111,2116,2116,2118,2117,2111,2107,2104,2104,2100,2099,2100,-16,-17,6.715298809080508,0
2108,2113,2111,2116,2116,2118,2117,2111,2107,2104,2104,2100,2099,2100,2103,-5,-8,6.631813656983463,0
2113,2111,2116,2116,2118,2117,2111,2107,2104,2104,2100,2099,2100,2103,2105,-8,-2,6.691857169796168,0
2111,2116,2116,2118,2117,2111,2107,2104,2104,2100,2099,2100,2103,2105,2109,-2,5,6.568322247184371,0
2116,2116,2118,2117,2111,2107,2104,2104,2100,2099,2100,2103,2105,2109,2111,-5,7,6.568322247184371,0
2116,2118,2117,2111,2107,2104,2104,2100,2099,2100,2103,2105,2109,2111,2108,-8,8,6.186005711819758,0
2118,2117,2111,2107,2104,2104,2100,2099,2100,2103,2105,2109,2111,2108,2104,-14,5,5.765248931147314,0
2117,2111,2107,2104,2104,2100,2099,2100,2103,2105,2109,2111,2108,2104,2101,-16,1,4.998094875145167,0
2111,2107,2104,2104,2100,2099,2100,2103,2105,2109,2111,2108,2104,2101,2100,-11,-3,4.049691346263317,0
2107,2104,2104,2100,2099,2100,2103,2105,2109,2111,2108,2104,2101,2100,2099,-8,-6,3.8321944477954513,0
2104,2104,2100,2099,2100,2103,2105,2109,2111,2108,2104,2101,2100,2099,2103,-1,-6,3.7161167647860327,0
2104,2100,2099,2100,2103,2105,2109,2111,2108,2104,2101,2100,2099,2103,2106,2,-5,3.777124126457412,0
2100,2099,2100,2103,2105,2109,2111,2108,2104,2101,2100,2099,2103,2106,2108,8,0,3.954503159449394,0
2099,2100,2103,2105,2109,2111,2108,2104,2101,2100,2099,2103,2106,2108,2111,12,7,4.2235169276439795,0
2100,2103,2105,2109,2111,2108,2104,2101,2100,2099,2103,2106,2108,2111,2110,10,9,4.161043825085926,0
2103,2105,2109,2111,2108,2104,2101,2100,2099,2103,2106,2108,2111,2110,2109,6,9,4.0035698356056475,0
2105,2109,2111,2108,2104,2101,2100,2099,2103,2106,2108,2111,2110,2109,2107,2,8,3.936399128040511,0
2109,2111,2108,2104,2101,2100,2099,2103,2106,2108,2111,2110,2109,2107,2106,-3,3,3.925496632214045,0
2111,2108,2104,2101,2100,2099,2103,2106,2108,2111,2110,2109,2107,2106,2101,-10,-5,4.049691346263317,0
2108,2104,2101,2100,2099,2103,2106,2108,2111,2110,2109,2107,2106,2101,2104,-4,-4,3.777124126457412,0
2104,2101,2100,2099,2103,2106,2108,2111,2110,2109,2107,2106,2101,2104,2104,0,-7,3.700707783010987,0
2101,2100,2099,2103,2106,2108,2111,2110,2109,2107,2106,2101,2104,2104,2108,7,-2,3.777124126457412,0
2100,2099,2103,2106,2108,2111,2110,2109,2107,2106,2101,2104,2104,2108,2110,10,1,3.7884536360342267,0
2099,2103,2106,2108,2111,2110,2109,2107,2106,2101,2104,2104,2108,2110,2112,13,5,3.7581657126595047,0
2103,2106,2108,2111,2110,2109,2107,2106,2101,2104,2104,2108,2110,2112,2111,8,5,3.2877840272018797,0
2106,2108,2111,2110,2109,2107,2106,2101,2104,2104,2108,2110,2112,2111,2111,5,10,3.1817934445544265,0
2108,2111,2110,2109,2107,2106,2101,2104,2104,2108,2110,2112,2111,2111,2108,0,4,3.1396087108337016,0
2111,2110,2109,2107,2106,2101,2104,2104,2108,2110,2112,2111,2111,2108,2105,-6,1,3.2337505867247796,0
2110,2109,2107,2106,2101,2104,2104,2108,2110,2112,2111,2111,2108,2105,2101,-9,-7,3.542933946940156,0
2109,2107,2106,2101,2104,2104,2108,2110,2112,2111,2111,2108,2105,2101,2103,-6,-7,3.5989416433697494,0
2107,2106,2101,2104,2104,2108,2110,2112,2111,2111,2108,2105,2101,2103,2102,-5,-10,3.7263540204487127,0
2106,2101,2104,2104,2108,2110,2112,2111,2111,2108,2105,2101,2103,2102,2107,1,-4,3.7263540204487127,0
2101,2104,2104,2108,2110,2112,2111,2111,2108,2105,2101,2103,2102,2107,2109,8,-2,3.794733192202055,0
2104,2104,2108,2110,2112,2111,2111,2108,2105,2101,2103,2102,2107,2109,2112,8,4,3.739111175259754,0
2104,2108,2110,2112,2111,2111,2108,2105,2101,2103,2102,2107,2109,2112,2113,9,8,3.9182114481458186,0
2108,2110,2112,2111,2111,2108,2105,2101,2103,2102,2107,2109,2112,2113,2107,-1,6,3.7884536360342267,0
2110,2112,2111,2111,2108,2105,2101,2103,2102,2107,2109,2112,2113,2107,2108,-2,5,3.7884536360342267,0
2112,2111,2111,2108,2105,2101,2103,2102,2107,2109,2112,2113,2107,2108,2103,-9,1,3.9436507137905803,0
2111,2111,2108,2105,2101,2103,2102,2107,2109,2112,2113,2107,2108,2103,2101,-10,-6,4.0614330100640705,0
2111,2108,2105,2101,2103,2102,2107,2109,2112,2113,2107,2108,2103,2101,2102,-9,-7,4.050867044167681,0
2108,2105,2101,2103,2102,2107,2109,2112,2113,2107,2108,2103,2101,2102,2103,-5,-9,3.8877095717511763,0
2105,2101,2103,2102,2107,2109,2112,2113,2107,2108,2103,2101,2102,2103,2106,1,-7,3.833436851604327,0
2101,2103,2102,2107,2109,2112,2113,2107,2108,2103,2101,2102,2103,2106,2111,10,4,4.085980677296223,0
2103,2102,2107,2109,2112,2113,2107,2108,2103,2101,2102,2103,2106,2111,2113,10,5,4.2370250120079485,0
2102,2107,2109,2112,2113,2107,2108,2103,2101,2102,2103,2106,2111,2113,2112,10,9,4.317186032370535,0
2107,2109,2112,2113,2107,2108,2103,2101,2102,2103,2106,2111,2113,2112,2112,5,11,4.216746658379227,0
2109,2112,2113,2107,2108,2103,2101,2102,2103,2106,2111,2113,2112,2112,2107,-2,5,4.216746658379227,0
2112,2113,2107,2108,2103,2101,2102,2103,2106,2111,2113,2112,2112,2107,2106,-6,3,4.2336520314982815,0
2113,2107,2108,2103,2101,2102,2103,2106,2111,2113,2112,2112,2107,2106,2102,-11,-4,4.3006090377106005,0
2107,2108,2103,2101,2102,2103,2106,2111,2113,2112,2112,2107,2106,2102,2103,-4,-8,4.08481508586549,0
2108,2103,2101,2102,2103,2106,2111,2113,2112,2112,2107,2106,2102,2103,2106,-2,-7,4.08248290463863,0
2103,2101,2102,2103,2106,2111,2113,2112,2112,2107,2106,2102,2103,2106,2109,6,-3,4.1196393739535715,0
2101,2102,2103,2106,2111,2113,2112,2112,2107,2106,2102,2103,2106,2109,2111,10,-1,4.1656189158852435,0
2102,2103,2106,2111,2113,2112,2112,2107,2106,2102,2103,2106,2109,2111,2111,9,4,3.9424430424366492,0
2103,2106,2111,2113,2112,2112,2107,2106,2102,2103,2106,2109,2111,2111,2113,10,7,3.8483144114694956,0
2106,2111,2113,2112,2112,2107,2106,2102,2103,2106,2109,2111,2111,2113,2109,3,7,3.5550098787619757,0
2111,2113,2112,2112,2107,2106,2102,2103,2106,2109,2111,2111,2113,2109,2110,-1,7,3.484660262185848,0
2113,2112,2112,2107,2106,2102,2103,2106,2109,2111,2111,2113,2109,2110,2106,-7,0,3.5186577527449843,0
2112,2112,2107,2106,2102,2103,2106,2109,2111,2111,2113,2109,2110,2106,2103,-9,-6,3.585685828003181,0
2112,2107,2106,2102,2103,2106,2109,2111,2111,2113,2109,2110,2106,2103,2104,-8,-7,3.542933946940156,0
2107,2106,2102,2103,2106,2109,2111,2111,2113,2109,2110,2106,2103,2104,2104,-3,-7,3.4114652626247333,0
2106,2102,2103,2106,2109,2111,2111,2113,2109,2110,2106,2103,2104,2104,2107,1,-6,3.4114652626247333,0
2102,2103,2106,2109,2111,2111,2113,2109,2110,2106,2103,2104,2104,2107,2109,7,0,3.4406533155921477,0
2103,2106,2109,2111,2111,2113,2109,2110,2106,2103,2104,2104,2107,2109,2113,10,3,3.4406533155921477,0
2106,2109,2111,2111,2113,2109,2110,2106,2103,2104,2104,2107,2109,2113,2114,8,8,3.5010202594590702,0
2109,2111,2111,2113,2109,2110,2106,2103,2104,2104,2107,2109,2113,2114,2112,3,9,3.525417908358019,0
2111,2111,2113,2109,2110,2106,2103,2104,2104,2107,2109,2113,2114,2112,2108,-3,4,3.5348604067541474,0
2111,2113,2109,2110,2106,2103,2104,2104,2107,2109,2113,2114,2112,2108,2106,-5,2,3.561701038227982,0
2113,2109,2110,2106,2103,2104,2104,2107,2109,2113,2114,2112,2108,2106,2103,-10,-4,3.76955220278534,0
2109,2110,2106,2103,2104,2104,2107,2109,2113,2114,2112,2108,2106,2103,2103,-6,-6,3.718678720805473,0
2110,2106,2103,2104,2104,2107,2109,2113,2114,2112,2108,2106,2103,2103,2105,-5,-8,3.739111175259754,0
2106,2103,2104,2104,2107,2109,2113,2114,2112,2108,2106,2103,2103,2105,2107,1,-7,3.65409098851971,0
2103,2104,2104,2107,2109,2113,2114,2112,2108,2106,2103,2103,2105,2107,2108,5,-4,3.65409098851971,0
2104,2104,2107,2109,2113,2114,2112,2108,2106,2103,2103,2105,2107,2108,2114,10,6,3.8766701469910267,0
2104,2107,2109,2113,2114,2112,2108,2106,2103,2103,2105,2107,2108,2114,2113,9,7,3.9424430424366492,0
2107,2109,2113,2114,2112,2108,2106,2103,2103,2105,2107,2108,2114,2113,2111,4,8,3.7959878568725443,0
2109,2113,2114,2112,2108,2106,2103,2103,2105,2107,2108,2114,2113,2111,2110,1,7,3.76955220278534,0
2113,2114,2112,2108,2106,2103,2103,2105,2107,2108,2114,2113,2111,2110,2106,-7,1,3.8520248231411016,0
2114,2112,2108,2106,2103,2103,2105,2107,2108,2114,2113,2111,2110,2106,2103,-11,-4,3.9496835316262997,0
2112,2108,2106,2103,2103,2105,2107,2108,2114,2113,2111,2110,2106,2103,2102,-10,-6,3.9060392800307135,0
2108,2106,2103,2103,2105,2107,2108,2114,2113,2111,2110,2106,2103,2102,2105,-3,-9,3.731462116089285,0
2106,2103,2103,2105,2107,2108,2114,2113,2111,2110,2106,2103,2102,2105,2107,1,-6,3.7199590371528606,0
2103,2103,2105,2107,2108,2114,2113,2111,2110,2106,2103,2102,2105,2107,2109,6,-2,3.750555514409388,0
2103,2105,2107,2108,2114,2113,2111,2110,2106,2103,2102,2105,2107,2109,2111,8,1,3.6994208040873486,0
2105,2107,2108,2114,2113,2111,2110,2106,2103,2102,2105,2107,2109,2111,2112,7,6,3.629246281451367,0
2107,2108,2114,2113,2111,2110,2106,2103,2102,2105,2107,2109,2111,2112,2112,5,9,3.6384193323605842,0
2108,2114,2113,2111,2110,2106,2103,2102,2105,2107,2109,2111,2112,2112,2108,0,6,3.6147844564602556,0
2114,2113,2111,2110,2106,2103,2102,2105,2107,2109,2111,2112,2112,2108,2107,-7,2,3.6384193323605842,0
2113,2111,2110,2106,2103,2102,2105,2107,2109,2111,2112,2112,2108,2107,2103,-10,-4,3.594970031002974,0
2111,2110,2106,2103,2102,2105,2107,2109,2111,2112,2112,2108,2107,2103,2103,-8,-6,3.5145954180219596,0
2110,2106,2103,2102,2105,2107,2109,2111,2112,2112,2108,2107,2103,2103,2104,-6,-7,3.4475664294853385,0
2106,2103,2102,2105,2107,2109,2111,2112,2112,2108,2107,2103,2103,2104,2105,-1,-7,3.3565855667130946,0
2103,2102,2105,2107,2109,2111,2112,2112,2108,2107,2103,2103,2104,2105,2108,5,-4,3.3763886032268267,0
2102,2105,2107,2109,2111,2112,2112,2108,2107,2103,2103,2104,2105,2108,2112,10,4,3.4887574537976374,0
2105,2107,2109,2111,2112,2112,2108,2107,2103,2103,2104,2105,2108,2112,2113,8,6,3.4737107920301407,0
2107,2109,2111,2112,2112,2108,2107,2103,2103,2104,2105,2108,2112,2113,2110,3,7,3.411465262624733,0
2109,2111,2112,2112,2108,2107,2103,2103,2104,2105,2108,2112,2113,2110,2108,-1,5,3.394673699166022,0
2111,2112,2112,2108,2107,2103,2103,2104,2105,2108,2112,2113,2110,2108,2106,-5,2,3.4406533155921477,0
2112,2112,2108,2107,2103,2103,2104,2105,2108,2112,2113,2110,2108,2106,2102,-10,-3,3.6813558578845584,0
2112,2108,2107,2103,2103,2104,2105,2108,2112,2113,2110,2108,2106,2102,2102,-10,-6,3.7199590371528606,0
2108,2107,2103,2103,2104,2105,2108,2112,2113,2110,2108,2106,2102,2102,2103,-5,-9,3.5550098787619757,0
2107,2103,2103,2104,2105,2108,2112,2113,2110,2108,2106,2102,2102,2103,2106,-1,-7,3.5227154028566954,0
2103,2103,2104,2105,2108,2112,2113,2110,2108,2106,2102,2102,2103,2106,2109,6,-1,3.594970031002974,0
2103,2104,2105,2108,2112,2113,2110,2108,2106,2102,2102,2103,2106,2109,2111,8,3,3.6683978597124463,0
2104,2105,2108,2112,2113,2110,2108,2106,2102,2102,2103,2106,2109,2111,2111,7,5,3.657998411830216,0
2105,2108,2112,2113,2110,2108,2106,2102,2102,2103,2106,2109,2111,2111,2111,6,9,3.6488745818794204,0
2108,2112,2113,2110,2108,2106,2102,2102,2103,2106,2109,2111,2111,2111,2109,1,7,3.575045787252575,0
2112,2113,2110,2108,2106,2102,2102,2103,2106,2109,2111,2111,2111,2109,2104,-8,1,3.7263540204487127,0
2113,2110,2108,2106,2102,2102,2103,2106,2109,2111,2111,2111,2109,2104,2101,-12,-5,3.9182114481458186,0
