f_0,f_1,f_2,f_3,f_4,f_5,f_6,f_7,f_8,f_9,f_10,f_11,f_12,f_13,f_14,diff,diff2,std,target
2079,2085,2092,2095,2092,2088,2080,2074,2074,2075,2080,2086,2094,2094,2094,15,20,7.909006318898788,0
2085,2092,2095,2092,2088,2080,2074,2074,2075,2080,2086,2094,2094,2094,2088,3,14,7.722570507162446,0
2092,2095,2092,2088,2080,2074,2074,2075,2080,2086,2094,2094,2094,2088,2079,-13,4,7.934253648099546,0
2095,2092,2088,2080,2074,2074,2075,2080,2086,2094,2094,2094,2088,2079,2077,-18,-3,8.023774198028779,0
2092,2088,2080,2074,2074,2075,2080,2086,2094,2094,2094,2088,2079,2077,2075,-17,-11,7.8437114635744685,0
2088,2080,2074,2074,2075,2080,2086,2094,2094,2094,2088,2079,2077,2075,2075,-13,-19,7.729350370041272,0
2080,2074,2074,2075,2080,2086,2094,2094,2094,2088,2079,2077,2075,2075,2080,0,-14,7.575021609272965,0
2074,2074,2075,2080,2086,2094,2094,2094,2088,2079,2077,2075,2075,2080,2087,13,-7,7.6799057533899715,0
2074,2075,2080,2086,2094,2094,2094,2088,2079,2077,2075,2075,2080,2087,2091,17,3,7.64821796860145,0
2075,2080,2086,2094,2094,2094,2088,2079,2077,2075,2075,2080,2087,2091,2094,19,15,7.660660172969056,0
2080,2086,2094,2094,2094,2088,2079,2077,2075,2075,2080,2087,2091,2094,2093,13,16,7.456540752922899,0
2086,2094,2094,2094,2088,2079,2077,2075,2075,2080,2087,2091,2094,2093,2087,1,12,7.284687135812125,0
2094,2094,2094,2088,2079,2077,2075,2075,2080,2087,2091,2094,2093,2087,2082,-12,7,7.367883976130073,0
2094,2094,2088,2079,2077,2075,2075,2080,2087,2091,2094,2093,2087,2082,2076,-18,-4,7.437357441610946,0
2094,2088,2079,2077,2075,2075,2080,2087,2091,2094,2093,2087,2082,2076,2071,-23,-16,7.768679485754381,0
2088,2079,2077,2075,2075,2080,2087,2091,2094,2093,2087,2082,2076,2071,2076,-12,-15,7.372406727275765,0
2079,2077,2075,2075,2080,2087,2091,2094,2093,2087,2082,2076,2071,2076,2079,0,-15,7.219682092987857,0
2077,2075,2075,2080,2087,2091,2094,2093,2087,2082,2076,2071,2076,2079,2087,10,-6,7.319250547113999,0
2075,2075,2080,2087,2091,2094,2093,2087,2082,2076,2071,2076,2079,2087,2091,16,4,7.525828541635482,0
2075,2080,2087,2091,2094,2093,2087,2082,2076,2071,2076,2079,2087,2091,2094,19,12,7.692296703288854,0
2080,2087,2091,2094,2093,2087,2082,2076,2071,2076,2079,2087,2091,2094,2094,14,18,7.633260552782583,0
2087,2091,2094,2093,2087,2082,2076,2071,2076,2079,2087,2091,2094,2094,2087,0,16,7.487767802667673,0
2091,2094,2093,2087,2082,2076,2071,2076,2079,2087,2091,2094,2094,2087,2083,-8,7,7.518231808331632,0
2094,2093,2087,2082,2076,2071,2076,2079,2087,2091,2094,2094,2087,2083,2078,-16,-1,7.608266181313209,0
2093,2087,2082,2076,2071,2076,2079,2087,2091,2094,2094,2087,2083,2078,2074,-19,-13,7.633260552782583,0
2087,2082,2076,2071,2076,2079,2087,2091,2094,2094,2087,2083,2078,2074,2074,-13,-17,7.5137968336349665,0
2082,2076,2071,2076,2079,2087,2091,2094,2094,2087,2083,2078,2074,2074,2078,-4,-16,7.462286129981501,0
2076,2071,2076,2079,2087,2091,2094,2094,2087,2083,2078,2074,2074,2078,2085,9,-9,7.5137968336349665,0
2071,2076,2079,2087,2091,2094,2094,2087,2083,2078,2074,2074,2078,2085,2092,21,5,7.7631608682718065,0
2076,2079,2087,2091,2094,2094,2087,2083,2078,2074,2074,2078,2085,2092,2094,18,11,7.519498463518504,0
2079,2087,2091,2094,2094,2087,2083,2078,2074,2074,2078,2085,2092,2094,2094,15,16,7.519498463518504,0
2087,2091,2094,2094,2087,2083,2078,2074,2074,2078,2085,2092,2094,2094,2091,4,17,7.404631755095687,0
2091,2094,2094,2087,2083,2078,2074,2074,2078,2085,2092,2094,2094,2091,2081,-10,7,7.5308887731984,0
2094,2094,2087,2083,2078,2074,2074,2078,2085,2092,2094,2094,2091,2081,2077,-17,-1,7.73181430072867,0
2094,2087,2083,2078,2074,2074,2078,2085,2092,2094,2094,2091,2081,2077,2074,-20,-11,7.805370556470047,0
2087,2083,2078,2074,2074,2078,2085,2092,2094,2094,2091,2081,2077,2074,2072,-15,-20,7.805370556470047,0
2083,2078,2074,2074,2078,2085,2092,2094,2094,2091,2081,2077,2074,2072,2078,-5,-16,7.761320457119087,0
2078,2074,2074,2078,2085,2092,2094,2094,2091,2081,2077,2074,2072,2078,2084,6,-10,7.77786848019675,0
2074,2074,2078,2085,2092,2094,2094,2091,2081,2077,2074,2072,2078,2084,2090,16,-1,7.980929651064348,0
2074,2078,2085,2092,2094,2094,2091,2081,2077,2074,2072,2078,2084,2090,2094,20,13,8.122866020128141,0
2078,2085,2092,2094,2094,2091,2081,2077,2074,2072,2078,2084,2090,2094,2094,16,17,8.028520589569592,0
2085,2092,2094,2094,2091,2081,2077,2074,2072,2078,2084,2090,2094,2094,2087,2,13,7.784600182411426,0
2092,2094,2094,2091,2081,2077,2074,2072,2078,2084,2090,2094,2094,2087,2084,-8,12,7.796213977370836,0
2094,2094,2091,2081,2077,2074,2072,2078,2084,2090,2094,2094,2087,2084,2079,-15,1,7.77235638719197,0
2094,2091,2081,2077,2074,2072,2078,2084,2090,2094,2094,2087,2084,2079,2073,-21,-11,7.899969861304776,0
2091,2081,2077,2074,2072,2078,2084,2090,2094,2094,2087,2084,2079,2073,2074,-17,-16,7.6799057533899715,0
2081,2077,2074,2072,2078,2084,2090,2094,2094,2087,2084,2079,2073,2074,2077,-4,-17,7.369822637912375,0
2077,2074,2072,2078,2084,2090,2094,2094,2087,2084,2079,2073,2074,2077,2084,7,-10,7.404631755095687,0
2074,2072,2078,2084,2090,2094,2094,2087,2084,2079,2073,2074,2077,2084,2092,18,5,7.771743691090179,0
2072,2078,2084,2090,2094,2094,2087,2084,2079,2073,2074,2077,2084,2092,2092,20,8,7.771743691090179,0
2078,2084,2090,2094,2094,2087,2084,2079,2073,2074,2077,2084,2092,2092,2093,15,14,7.416198487095663,0
2084,2090,2094,2094,2087,2084,2079,2073,2074,2077,2084,2092,2092,2093,2090,6,17,7.252585745787498,0
2090,2094,2094,2087,2084,2079,2073,2074,2077,2084,2092,2092,2093,2090,2083,-7,9,7.274875223934052,0
2094,2094,2087,2084,2079,2073,2074,2077,2084,2092,2092,2093,2090,2083,2077,-17,0,7.501111028818776,0
2094,2087,2084,2079,2073,2074,2077,2084,2092,2092,2093,2090,2083,2077,2072,-22,-12,7.734893110352038,0
2087,2084,2079,2073,2074,2077,2084,2092,2092,2093,2090,2083,2077,2072,2073,-14,-19,7.578164119928482,0
2084,2079,2073,2074,2077,2084,2092,2092,2093,2090,2083,2077,2072,2073,2079,-5,-13,7.482041992728481,0
2079,2073,2074,2077,2084,2092,2092,2093,2090,2083,2077,2072,2073,2079,2085,6,-8,7.510627391205332,0
2073,2074,2077,2084,2092,2092,2093,2090,2083,2077,2072,2073,2079,2085,2090,17,0,7.77786848019675,0
2074,2077,2084,2092,2092,2093,2090,2083,2077,2072,2073,2079,2085,2090,2093,19,10,7.790103612001209,0
2077,2084,2092,2092,2093,2090,2083,2077,2072,2073,2079,2085,2090,2093,2094,17,17,7.741047056038965,0
2084,2092,2092,2093,2090,2083,2077,2072,2073,2079,2085,2090,2093,2094,2091,7,19,7.558029473600214,0
2092,2092,2093,2090,2083,2077,2072,2073,2079,2085,2090,2093,2094,2091,2084,-8,11,7.558029473600214,0
2092,2093,2090,2083,2077,2072,2073,2079,2085,2090,2093,2094,2091,2084,2077,-15,-2,7.6799057533899715,0
2093,2090,2083,2077,2072,2073,2079,2085,2090,2093,2094,2091,2084,2077,2073,-20,-12,7.98033296834877,0
2090,2083,2077,2072,2073,2079,2085,2090,2093,2094,2091,2084,2077,2073,2074,-16,-16,7.889112449325034,0
2083,2077,2072,2073,2079,2085,2090,2093,2094,2091,2084,2077,2073,2074,2075,-8,-18,7.798046153333783,0
2077,2072,2073,2079,2085,2090,2093,2094,2091,2084,2077,2073,2074,2075,2085,8,-9,7.845532547404347,0
2072,2073,2079,2085,2090,2093,2094,2091,2084,2077,2073,2074,2075,2085,2089,17,-2,7.968389931174182,0
2073,2079,2085,2090,2093,2094,2091,2084,2077,2073,2074,2075,2085,2089,2093,20,9,7.88005317845242,0
2079,2085,2090,2093,2094,2091,2084,2077,2073,2074,2075,2085,2089,2093,2096,17,19,7.8939398093908535,0
2085,2090,2093,2094,2091,2084,2077,2073,2074,2075,2085,2089,2093,2096,2091,6,18,7.828519290754433,0
2090,2093,2094,2091,2084,2077,2073,2074,2075,2085,2089,2093,2096,2091,2087,-3,13,7.827302643099133,0
2093,2094,2091,2084,2077,2073,2074,2075,2085,2089,2093,2096,2091,2087,2079,-14,4,7.953435915196831,0
2094,2091,2084,2077,2073,2074,2075,2085,2089,2093,2096,2091,2087,2079,2076,-18,-9,8.004165582161995,0
2091,2084,2077,2073,2074,2075,2085,2089,2093,2096,2091,2087,2079,2076,2074,-17,-15,7.932452932341264,0
2084,2077,2073,2074,2075,2085,2089,2093,2096,2091,2087,2079,2076,2074,2077,-7,-16,7.736739808029145,0
2077,2073,2074,2075,2085,2089,2093,2096,2091,2087,2079,2076,2074,2077,2083,6,-13,7.722570507162446,0
2073,2074,2075,2085,2089,2093,2096,2091,2087,2079,2076,2074,2077,2083,2089,16,-2,7.796213977370836,0
2074,2075,2085,2089,2093,2096,2091,2087,2079,2076,2074,2077,2083,2089,2093,19,6,7.722570507162446,0
2075,2085,2089,2093,2096,2091,2087,2079,2076,2074,2077,2083,2089,2093,2096,21,17,7.7631608682718065,0
2085,2089,2093,2096,2091,2087,2079,2076,2074,2077,2083,2089,2093,2096,2092,7,16,7.3452284479368615,0
2089,2093,2096,2091,2087,2079,2076,2074,2077,2083,2089,2093,2096,2092,2088,-1,14,7.337444734926134,0
2093,2096,2091,2087,2079,2076,2074,2077,2083,2089,2093,2096,2092,2088,2081,-12,4,7.461009761866464,0
2096,2091,2087,2079,2076,2074,2077,2083,2089,2093,2096,2092,2088,2081,2076,-20,-7,7.6643888955909025,0
2091,2087,2079,2076,2074,2077,2083,2089,2093,2096,2092,2088,2081,2076,2074,-17,-15,7.554248252914824,0
2087,2079,2076,2074,2077,2083,2089,2093,2096,2092,2088,2081,2076,2074,2079,-8,-14,7.362711715769117,0
2079,2076,2074,2077,2083,2089,2093,2096,2092,2088,2081,2076,2074,2079,2085,6,-11,7.301663215616406,0
2076,2074,2077,2083,2089,2093,2096,2092,2088,2081,2076,2074,2079,2085,2091,15,-1,7.5099933422074345,0
2074,2077,2083,2089,2093,2096,2092,2088,2081,2076,2074,2079,2085,2091,2096,22,8,7.8327760693371635,0
2077,2083,2089,2093,2096,2092,2088,2081,2076,2074,2079,2085,2091,2096,2097,20,16,7.790714864198156,0
2083,2089,2093,2096,2092,2088,2081,2076,2074,2079,2085,2091,2096,2097,2094,11,18,7.547942009013355,0
2089,2093,2096,2092,2088,2081,2076,2074,2079,2085,2091,2096,2097,2094,2087,-2,13,7.443757371752777,0
2093,2096,2092,2088,2081,2076,2074,2079,2085,2091,2096,2097,2094,2087,2084,-9,5,7.501111028818776,0
2096,2092,2088,2081,2076,2074,2079,2085,2091,2096,2097,2094,2087,2084,2079,-17,-6,7.64198926981712,0
2092,2088,2081,2076,2074,2079,2085,2091,2096,2097,2094,2087,2084,2079,2079,-13,-12,7.405274825291444,0
2088,2081,2076,2074,2079,2085,2091,2096,2097,2094,2087,2084,2079,2079,2080,-8,-16,7.296444013222827,0
2081,2076,2074,2079,2085,2091,2096,2097,2094,2087,2084,2079,2079,2080,2086,5,-11,7.249302101056415,0
2076,2074,2079,2085,2091,2096,2097,2094,2087,2084,2079,2079,2080,2086,2094,18,0,7.566844973774926,0
2074,2079,2085,2091,2096,2097,2094,2087,2084,2079,2079,2080,2086,2094,2099,25,12,7.85099326442809,0
2079,2085,2091,2096,2097,2094,2087,2084,2079,2079,2080,2086,2094,2099,2099,20,15,7.557399401532627,0
2085,2091,2096,2097,2094,2087,2084,2079,2079,2080,2086,2094,2099,2099,2101,16,22,7.69477249888025,0
2091,2096,2097,2094,2087,2084,2079,2079,2080,2086,2094,2099,2099,2101,2093,2,14,7.595111209568579,0
2096,2097,2094,2087,2084,2079,2079,2080,2086,2094,2099,2099,2101,2093,2092,-4,12,7.603257447273754,0
2097,2094,2087,2084,2079,2079,2080,2086,2094,2099,2099,2101,2093,2092,2088,-9,2,7.482041992728481,0
2094,2087,2084,2079,2079,2080,2086,2094,2099,2099,2101,2093,2092,2088,2087,-7,-7,7.268981719477305,0
2087,2084,2079,2079,2080,2086,2094,2099,2099,2101,2093,2092,2088,2087,2092,5,-7,7.197883286739499,0
2084,2079,2079,2080,2086,2094,2099,2099,2101,2093,2092,2088,2087,2092,2095,11,-4,7.30818197703942,0
2079,2079,2080,2086,2094,2099,2099,2101,2093,2092,2088,2087,2092,2095,2102,23,1,7.741047056038965,0
2079,2080,2086,2094,2099,2099,2101,2093,2092,2088,2087,2092,2095,2102,2107,28,14,7.995236677160316,0
2080,2086,2094,2099,2099,2101,2093,2092,2088,2087,2092,2095,2102,2107,2105,25,13,7.565586245499765,0
2086,2094,2099,2099,2101,2093,2092,2088,2087,2092,2095,2102,2107,2105,2135,49,47,11.98610306424347,0
2094,2099,2099,2101,2093,2092,2088,2087,2092,2095,2102,2107,2105,2135,2139,45,52,15.412734376235157,0
2099,2099,2101,2093,2092,2088,2087,2092,2095,2102,2107,2105,2135,2139,2143,44,51,18.508170653859366,0
2099,2101,2093,2092,2088,2087,2092,2095,2102,2107,2105,2135,2139,2143,2146,47,51,21.18107870808508,0
2101,2093,2092,2088,2087,2092,2095,2102,2107,2105,2135,2139,2143,2146,2145,44,43,22.99585884044177,0
2093,2092,2088,2087,2092,2095,2102,2107,2105,2135,2139,2143,2146,2145,2140,47,33,23.92985781901128,0
2092,2088,2087,2092,2095,2102,2107,2105,2135,2139,2143,2146,2145,2140,2146,54,41,24.52365233421653,0
2088,2087,2092,2095,2102,2107,2105,2135,2139,2143,2146,2145,2140,2146,2147,59,12,24.555670473048632,0
2087,2092,2095,2102,2107,2105,2135,2139,2143,2146,2145,2140,2146,2147,2146,59,7,23.509876344087512,0
2092,2095,2102,2107,2105,2135,2139,2143,2146,2145,2140,2146,2147,2146,2139,47,-4,21.229584030198005,0
2095,2102,2107,2105,2135,2139,2143,2146,2145,2140,2146,2147,2146,2139,2128,33,-18,18.696319984220985,0
2102,2107,2105,2135,2139,2143,2146,2145,2140,2146,2147,2146,2139,2128,2125,23,-20,15.9949396759755,0
2107,2105,2135,2139,2143,2146,2145,2140,2146,2147,2146,2139,2128,2125,2126,19,-14,13.726234873756306,0
2105,2135,2139,2143,2146,2145,2140,2146,2147,2146,2139,2128,2125,2126,2106,1,-40,13.870832707519762,0
2135,2139,2143,2146,2145,2140,2146,2147,2146,2139,2128,2125,2126,2106,2084,-51,-63,17.60681686165901,0
2139,2143,2146,2145,2140,2146,2147,2146,2139,2128,2125,2126,2106,2084,2093,-46,-53,20.386269889315212,0
2143,2146,2145,2140,2146,2147,2146,2139,2128,2125,2126,2106,2084,2093,2095,-48,-44,22.121310561365505,0
2146,2145,2140,2146,2147,2146,2139,2128,2125,2126,2106,2084,2093,2095,2056,-90,-72,28.256141346785547,0
2145,2140,2146,2147,2146,2139,2128,2125,2126,2106,2084,2093,2095,2056,2064,-81,-61,30.972337888601732,0
2140,2146,2147,2146,2139,2128,2125,2126,2106,2084,2093,2095,2056,2064,2049,-91,-77,34.292439816545986,0
2146,2147,2146,2139,2128,2125,2126,2106,2084,2093,2095,2056,2064,2049,2021,-125,-85,40.0404557321479,0
2147,2146,2139,2128,2125,2126,2106,2084,2093,2095,2056,2064,2049,2021,2050,-97,-34,40.120295303475714,0
2146,2139,2128,2125,2126,2106,2084,2093,2095,2056,2064,2049,2021,2050,2072,-74,-21,37.8199997481806,0
2139,2128,2125,2126,2106,2084,2093,2095,2056,2064,2049,2021,2050,2072,2073,-66,-22,34.70446657132191,0
2128,2125,2126,2106,2084,2093,2095,2056,2064,2049,2021,2050,2072,2073,2050,-78,-6,32.41883638227863,0
2125,2126,2106,2084,2093,2095,2056,2064,2049,2021,2050,2072,2073,2050,2079,-46,15,29.518033229100574,0
2126,2106,2084,2093,2095,2056,2064,2049,2021,2050,2072,2073,2050,2079,2086,-40,37,26.473167007907676,0
2106,2084,2093,2095,2056,2064,2049,2021,2050,2072,2073,2050,2079,2086,2104,-2,83,23.841340646228847,0
2084,2093,2095,2056,2064,2049,2021,2050,2072,2073,2050,2079,2086,2104,2103,19,53,23.547722567060237,0
2093,2095,2056,2064,2049,2021,2050,2072,2073,2050,2079,2086,2104,2103,2036,-57,-36,25.007046625948874,0
2095,2056,2064,2049,2021,2050,2072,2073,2050,2079,2086,2104,2103,2036,2099,4,26,25.466691598093007,0
2056,2064,2049,2021,2050,2072,2073,2050,2079,2086,2104,2103,2036,2099,2110,54,60,26.81382017506928,0
2064,2049,2021,2050,2072,2073,2050,2079,2086,2104,2103,2036,2099,2110,2116,52,37,28.945433063578356,0
2049,2021,2050,2072,2073,2050,2079,2086,2104,2103,2036,2099,2110,2116,2117,68,31,30.79579439438042,0
2021,2050,2072,2073,2050,2079,2086,2104,2103,2036,2099,2110,2116,2117,2118,97,14,31.356172020983745,0
2050,2072,2073,2050,2079,2086,2104,2103,2036,2099,2110,2116,2117,2118,2117,67,14,27.520555088532507,0
2072,2073,2050,2079,2086,2104,2103,2036,2099,2110,2116,2117,2118,2117,2118,46,82,26.268394915345922,0
2073,2050,2079,2086,2104,2103,2036,2099,2110,2116,2117,2118,2117,2118,2117,44,18,26.243910858384982,0
2050,2079,2086,2104,2103,2036,2099,2110,2116,2117,2118,2117,2118,2117,2119,69,9,26.025994331675033,0
2079,2086,2104,2103,2036,2099,2110,2116,2117,2118,2117,2118,2117,2119,2121,42,5,22.665266063169998,0
2086,2104,2103,2036,2099,2110,2116,2117,2118,2117,2118,2117,2119,2121,2121,35,4,21.938876126964338,0
2104,2103,2036,2099,2110,2116,2117,2118,2117,2118,2117,2119,2121,2121,2123,19,5,21.50902357705006,0
2103,2036,2099,2110,2116,2117,2118,2117,2118,2117,2119,2121,2121,2123,2122,19,5,21.69551193438952,0
2036,2099,2110,2116,2117,2118,2117,2118,2117,2119,2121,2121,2123,2122,2122,86,4,21.782911607387064,0
2099,2110,2116,2117,2118,2117,2118,2117,2119,2121,2121,2123,2122,2122,2121,22,4,6.045068828628599,1
2110,2116,2117,2118,2117,2118,2117,2119,2121,2121,2123,2122,2122,2121,2120,10,1,3.277629805645711,1
2116,2117,2118,2117,2118,2117,2119,2121,2121,2123,2122,2122,2121,2120,2121,5,0,2.2318047362958033,1
2117,2118,2117,2118,2117,2119,2121,2121,2123,2122,2122,2121,2120,2121,2126,9,5,2.569046515733026,1
2118,2117,2118,2117,2119,2121,2121,2123,2122,2122,2121,2120,2121,2126,2124,6,1,2.581988897471611,1
2117,2118,2117,2119,2121,2121,2123,2122,2122,2121,2120,2121,2126,2124,2123,6,1,2.53546276418555,1
2118,2117,2119,2121,2121,2123,2122,2122,2121,2120,2121,2126,2124,2123,2125,7,3,2.4746332099544617,1
2117,2119,2121,2121,2123,2122,2122,2121,2120,2121,2126,2124,2123,2125,2121,4,0,2.282438128301359,1
2119,2121,2121,2123,2122,2122,2121,2120,2121,2126,2124,2123,2125,2121,2123,4,3,1.88477610139267,1
2121,2121,2123,2122,2122,2121,2120,2121,2126,2124,2123,2125,2121,2123,2119,-2,-2,1.88477610139267,1
2121,2123,2122,2122,2121,2120,2121,2126,2124,2123,2125,2121,2123,2119,2120,-1,-6,1.9444671200491874,1
2123,2122,2122,2121,2120,2121,2126,2124,2123,2125,2121,2123,2119,2120,2121,-2,-3,1.9444671200491874,1
2122,2122,2121,2120,2121,2126,2124,2123,2125,2121,2123,2119,2120,2121,2120,-2,-3,1.995232412766087,1
2122,2121,2120,2121,2126,2124,2123,2125,2121,2123,2119,2120,2121,2120,2123,1,-2,2.016597794967223,1
2121,2120,2121,2126,2124,2123,2125,2121,2123,2119,2120,2121,2120,2123,2124,3,3,2.086236073022646,1
2120,2121,2126,2124,2123,2125,2121,2123,2119,2120,2121,2120,2123,2124,2124,4,1,2.1201976547572388,0
2121,2126,2124,2123,2125,2121,2123,2119,2120,2121,2120,2123,2124,2124,2126,5,7,2.2253945610567474,0
2126,2124,2123,2125,2121,2123,2119,2120,2121,2120,2123,2124,2124,2126,2123,-3,3,2.177810171446801,0
2124,2123,2125,2121,2123,2119,2120,2121,2120,2123,2124,2124,2126,2123,2121,-3,0,2.0307165050320353,0
2123,2125,2121,2123,2119,2120,2121,2120,2123,2124,2124,2126,2123,2121,2118,-5,-2,2.282438128301359,0
2125,2121,2123,2119,2120,2121,2120,2123,2124,2124,2126,2123,2121,2118,2122,-3,-1,2.2677868380553634,0
2121,2123,2119,2120,2121,2120,2123,2124,2124,2126,2123,2121,2118,2122,2336,215,212,55.35014087821362,0
2123,2119,2120,2121,2120,2123,2124,2124,2126,2123,2121,2118,2122,2336,2322,199,198,72.96855160827522,0
2119,2120,2121,2120,2123,2124,2124,2126,2123,2121,2118,2122,2336,2322,2336,217,210,86.8542841008241,0
2120,2121,2120,2123,2124,2124,2126,2123,2121,2118,2122,2336,2322,2336,2348,228,225,97.86978715668711,0
2121,2120,2123,2124,2124,2126,2123,2121,2118,2122,2336,2322,2336,2348,2349,228,228,105.57745971560406,0
2120,2123,2124,2124,2126,2123,2121,2118,2122,2336,2322,2336,2348,2349,2332,212,214,109.12474294956907,0
2123,2124,2124,2126,2123,2121,2118,2122,2336,2322,2336,2348,2349,2332,2332,209,210,110.59501409583139,0
2124,2124,2126,2123,2121,2118,2122,2336,2322,2336,2348,2349,2332,2332,2318,194,-18,109.53199141281574,0
2124,2126,2123,2121,2118,2122,2336,2322,2336,2348,2349,2332,2332,2318,2333,209,11,107.62545282245318,0
2126,2123,2121,2118,2122,2336,2322,2336,2348,2349,2332,2332,2318,2333,2315,189,-21,102.93442202730454,0
2123,2121,2118,2122,2336,2322,2336,2348,2349,2332,2332,2318,2333,2315,2333,210,-15,97.09999754793778,0
2121,2118,2122,2336,2322,2336,2348,2349,2332,2332,2318,2333,2315,2333,2310,189,-39,87.61251269626035,0
2118,2122,2336,2322,2336,2348,2349,2332,2332,2318,2333,2315,2333,2310,2317,199,-15,74.5096350432997,0
2122,2336,2322,2336,2348,2349,2332,2332,2318,2333,2315,2333,2310,2317,2321,199,-11,54.59260372021453,0
2336,2322,2336,2348,2349,2332,2332,2318,2333,2315,2333,2310,2317,2321,2325,-11,7,11.5131394915714,0
2322,2336,2348,2349,2332,2332,2318,2333,2315,2333,2310,2317,2321,2325,2339,17,6,11.678225566452824,0
2336,2348,2349,2332,2332,2318,2333,2315,2333,2310,2317,2321,2325,2339,2331,-5,16,11.54164302902857,0
2348,2349,2332,2332,2318,2333,2315,2333,2310,2317,2321,2325,2339,2331,2305,-43,-28,12.94052328374486,0
2349,2332,2332,2318,2333,2315,2333,2310,2317,2321,2325,2339,2331,2305,2319,-30,9,11.719743211878873,0
2332,2332,2318,2333,2315,2333,2310,2317,2321,2325,2339,2331,2305,2319,2307,-25,-10,10.609070692213383,0
2332,2318,2333,2315,2333,2310,2317,2321,2325,2339,2331,2305,2319,2307,2299,-33,-22,11.841010252910172,0
2318,2333,2315,2333,2310,2317,2321,2325,2339,2331,2305,2319,2307,2299,2322,4,-3,11.406764910099872,0
2333,2315,2333,2310,2317,2321,2325,2339,2331,2305,2319,2307,2299,2322,2305,-28,-34,12.014673568282285,0
2315,2333,2310,2317,2321,2325,2339,2331,2305,2319,2307,2299,2322,2305,2332,17,1,11.93234898839924,0
2333,2310,2317,2321,2325,2339,2331,2305,2319,2307,2299,2322,2305,2332,2322,-11,17,11.915576040668466,0
2310,2317,2321,2325,2339,2331,2305,2319,2307,2299,2322,2305,2332,2322,2319,9,0,11.283363227082859,0
2317,2321,2325,2339,2331,2305,2319,2307,2299,2322,2305,2332,2322,2319,2344,27,37,12.827797197975222,0
2321,2325,2339,2331,2305,2319,2307,2299,2322,2305,2332,2322,2319,2344,2321,0,22,12.792110663924669,0
2325,2339,2331,2305,2319,2307,2299,2322,2305,2332,2322,2319,2344,2321,2282,-43,-40,16.234296441557944,0
2339,2331,2305,2319,2307,2299,2322,2305,2332,2322,2319,2344,2321,2282,2342,3,37,17.305930720283094,0
2331,2305,2319,2307,2299,2322,2305,2332,2322,2319,2344,2321,2282,2342,2322,-9,-10,16.457159391526087,0
2305,2319,2307,2299,2322,2305,2332,2322,2319,2344,2321,2282,2342,2322,2318,13,-4,16.06889927187061,0
2319,2307,2299,2322,2305,2332,2322,2319,2344,2321,2282,2342,2322,2318,2310,-9,-9,15.846585932442538,0
2307,2299,2322,2305,2332,2322,2319,2344,2321,2282,2342,2322,2318,2310,2310,3,-34,15.959770854065722,0
2299,2322,2305,2332,2322,2319,2344,2321,2282,2342,2322,2318,2310,2310,2318,19,-3,15.718354451616959,0
2322,2305,2332,2322,2319,2344,2321,2282,2342,2322,2318,2310,2310,2318,2312,-10,30,14.951349676295353,0
2305,2332,2322,2319,2344,2321,2282,2342,2322,2318,2310,2310,2318,2312,2315,10,-27,14.946890104952395,0
2332,2322,2319,2344,2321,2282,2342,2322,2318,2310,2310,2318,2312,2315,2324,-8,2,14.5543317066972,0
2322,2319,2344,2321,2282,2342,2322,2318,2310,2310,2318,2312,2315,2324,2300,-22,-18,14.916274269911977,0
2319,2344,2321,2282,2342,2322,2318,2310,2310,2318,2312,2315,2324,2300,2324,5,14,14.970447077969506,0
2344,2321,2282,2342,2322,2318,2310,2310,2318,2312,2315,2324,2300,2324,2315,-29,5,14.975535605335345,0
2321,2282,2342,2322,2318,2310,2310,2318,2312,2315,2324,2300,2324,2315,2322,1,4,13.11850746446554,0
2282,2342,2322,2318,2310,2310,2318,2312,2315,2324,2300,2324,2315,2322,2294,12,-18,14.146512274190043,0
2342,2322,2318,2310,2310,2318,2312,2315,2324,2300,2324,2315,2322,2294,2328,-14,13,11.479588510959458,0
2322,2318,2310,2310,2318,2312,2315,2324,2300,2324,2315,2322,2294,2328,2318,-4,-6,9.178131358729578,0
2318,2310,2310,2318,2312,2315,2324,2300,2324,2315,2322,2294,2328,2318,2313,-5,13,9.003702941938204,0
2310,2310,2318,2312,2315,2324,2300,2324,2315,2322,2294,2328,2318,2313,2319,9,-5,9.033271832508971,0
2310,2318,2312,2315,2324,2300,2324,2315,2322,2294,2328,2318,2313,2319,2326,16,11,9.364573567185966,0
2318,2312,2315,2324,2300,2324,2315,2322,2294,2328,2318,2313,2319,2326,2318,0,-4,9.233479455608425,0
2312,2315,2324,2300,2324,2315,2322,2294,2328,2318,2313,2319,2326,2318,2318,6,24,9.233479455608425,0
2315,2324,2300,2324,2315,2322,2294,2328,2318,2313,2319,2326,2318,2318,2305,-10,-23,9.63969965941935,0
2324,2300,2324,2315,2322,2294,2328,2318,2313,2319,2326,2318,2318,2305,2306,-18,-12,9.976162063830435,0
2300,2324,2315,2322,2294,2328,2318,2313,2319,2326,2318,2318,2305,2306,2331,31,18,10.557326501399057,0
2324,2315,2322,2294,2328,2318,2313,2319,2326,2318,2318,2305,2306,2331,2335,11,16,10.68287459084911,0
2315,2322,2294,2328,2318,2313,2319,2326,2318,2318,2305,2306,2331,2335,2330,15,4,11.02507963474101,0
2322,2294,2328,2318,2313,2319,2326,2318,2318,2305,2306,2331,2335,2330,2298,-24,-20,12.222929272478018,0
2294,2328,2318,2313,2319,2326,2318,2318,2305,2306,2331,2335,2330,2298,2326,32,8,12.37316604977231,0
2328,2318,2313,2319,2326,2318,2318,2305,2306,2331,2335,2330,2298,2326,2310,-18,5,10.773424092026948,0
2318,2313,2319,2326,2318,2318,2305,2306,2331,2335,2330,2298,2326,2310,2333,15,27,11.151339872516708,0
2313,2319,2326,2318,2318,2305,2306,2331,2335,2330,2298,2326,2310,2333,2293,-20,-38,13.031829166643162,0
2319,2326,2318,2318,2305,2306,2331,2335,2330,2298,2326,2310,2333,2293,2333,14,-2,13.561851257251332,0
2326,2318,2318,2305,2306,2331,2335,2330,2298,2326,2310,2333,2293,2333,2335,9,5,14.198591479439079,0
2318,2318,2305,2306,2331,2335,2330,2298,2326,2310,2333,2293,2333,2335,2331,13,33,14.411635510768308,0
2318,2305,2306,2331,2335,2330,2298,2326,2310,2333,2293,2333,2335,2331,2341,23,15,15.360741549560064,0
2305,2306,2331,2335,2330,2298,2326,2310,2333,2293,2333,2335,2331,2341,2315,10,5,15.431260788536026,0
2306,2331,2335,2330,2298,2326,2310,2333,2293,2333,2335,2331,2341,2315,2337,31,4,15.20244341263225,0
2331,2335,2330,2298,2326,2310,2333,2293,2333,2335,2331,2341,2315,2337,2301,-30,8,15.66372819453852,0
2335,2330,2298,2326,2310,2333,2293,2333,2335,2331,2341,2315,2337,2301,2334,-1,1,15.788181233652807,0
2330,2298,2326,2310,2333,2293,2333,2335,2331,2341,2315,2337,2301,2334,2324,-6,-11,15.466399833494664,0
2298,2326,2310,2333,2293,2333,2335,2331,2341,2315,2337,2301,2334,2324,2302,4,-29,16.199059349527793,0
2326,2310,2333,2293,2333,2335,2331,2341,2315,2337,2301,2334,2324,2302,2320,-6,-21,14.926805546047815,0
2310,2333,2293,2333,2335,2331,2341,2315,2337,2301,2334,2324,2302,2320,2316,6,1,14.974581638165898,0
2333,2293,2333,2335,2331,2341,2315,2337,2301,2334,2324,2302,2320,2316,2317,-16,-20,14.69142931229277,0
2293,2333,2335,2331,2341,2315,2337,2301,2334,2324,2302,2320,2316,2317,2295,2,-6,15.909565855619245,0
2333,2335,2331,2341,2315,2337,2301,2334,2324,2302,2320,2316,2317,2295,2317,-16,-17,14.153242939845473,0
2335,2331,2341,2315,2337,2301,2334,2324,2302,2320,2316,2317,2295,2317,2322,-13,-2,13.778174597460117,0
2331,2341,2315,2337,2301,2334,2324,2302,2320,2316,2317,2295,2317,2322,2297,-34,-5,14.394774184040672,0
2341,2315,2337,2301,2334,2324,2302,2320,2316,2317,2295,2317,2322,2297,2325,-16,5,14.08579155779056,0
2315,2337,2301,2334,2324,2302,2320,2316,2317,2295,2317,2322,2297,2325,2319,4,3,12.526923386203395,0
2337,2301,2334,2324,2302,2320,2316,2317,2295,2317,2322,2297,2325,2319,2324,-13,7,12.68670094833093,0
2301,2334,2324,2302,2320,2316,2317,2295,2317,2322,2297,2325,2319,2324,2300,-1,5,12.030912564841335,0
2334,2324,2302,2320,2316,2317,2295,2317,2322,2297,2325,2319,2324,2300,2321,-13,4,11.56266570022839,0
2324,2302,2320,2316,2317,2295,2317,2322,2297,2325,2319,2324,2300,2321,2318,-6,-4,10.41884739078085,0
2302,2320,2316,2317,2295,2317,2322,2297,2325,2319,2324,2300,2321,2318,2316,14,19,10.095732243072293,0
2320,2316,2317,2295,2317,2322,2297,2325,2319,2324,2300,2321,2318,2316,2320,0,-5,9.635252733483187,0
2316,2317,2295,2317,2322,2297,2325,2319,2324,2300,2321,2318,2316,2320,2327,11,8,10.048454038877253,0
2317,2295,2317,2322,2297,2325,2319,2324,2300,2321,2318,2316,2320,2327,2314,-3,-10,10.056033488598251,0
2295,2317,2322,2297,2325,2319,2324,2300,2321,2318,2316,2320,2327,2314,2315,20,15,10.04750620564033,0
2317,2322,2297,2325,2319,2324,2300,2321,2318,2316,2320,2327,2314,2315,2323,6,2,8.478544349457298,0
2322,2297,2325,2319,2324,2300,2321,2318,2316,2320,2327,2314,2315,2323,2330,8,12,9.098403836989892,0
2297,2325,2319,2324,2300,2321,2318,2316,2320,2327,2314,2315,2323,2330,2324,27,8,9.174498818542,0
2325,2319,2324,2300,2321,2318,2316,2320,2327,2314,2315,2323,2330,2324,2345,20,25,9.612491872558333,0
2319,2324,2300,2321,2318,2316,2320,2327,2314,2315,2323,2330,2324,2345,2312,-7,-15,9.847890757972104,0
2324,2300,2321,2318,2316,2320,2327,2314,2315,2323,2330,2324,2345,2312,2339,15,25,10.920927921503129,0
2300,2321,2318,2316,2320,2327,2314,2315,2323,2330,2324,2345,2312,2339,2334,34,19,11.356978135972279,0
2321,2318,2316,2320,2327,2314,2315,2323,2330,2324,2345,2312,2339,2334,2337,16,14,10.05698051817031,0
2318,2316,2320,2327,2314,2315,2323,2330,2324,2345,2312,2339,2334,2337,2337,19,7,10.443498775155128,0
2316,2320,2327,2314,2315,2323,2330,2324,2345,2312,2339,2334,2337,2337,2317,1,-7,10.501700542565203,0
2320,2327,2314,2315,2323,2330,2324,2345,2312,2339,2334,2337,2337,2317,2322,2,-23,10.203640806804486,0
2327,2314,2315,2323,2330,2324,2345,2312,2339,2334,2337,2337,2317,2322,2311,-16,-1,10.850938076629925,0
2314,2315,2323,2330,2324,2345,2312,2339,2334,2337,2337,2317,2322,2311,2314,0,-25,11.25970480878395,0
2315,2323,2330,2324,2345,2312,2339,2334,2337,2337,2317,2322,2311,2314,2332,17,-2,10.966616007988366,0
2323,2330,2324,2345,2312,2339,2334,2337,2337,2317,2322,2311,2314,2332,2327,4,-10,10.525253079187806,0
2330,2324,2345,2312,2339,2334,2337,2337,2317,2322,2311,2314,2332,2327,2326,-4,-11,10.473549450651298,0
2324,2345,2312,2339,2334,2337,2337,2317,2322,2311,2314,2332,2327,2326,2334,10,17,10.601886624558858,0
2345,2312,2339,2334,2337,2337,2317,2322,2311,2314,2332,2327,2326,2334,2322,-23,0,10.660117036791634,0
2312,2339,2334,2337,2337,2317,2322,2311,2314,2332,2327,2326,2334,2322,2320,8,9,9.590173542299878,0
2339,2334,2337,2337,2317,2322,2311,2314,2332,2327,2326,2334,2322,2320,2335,-4,21,9.085834081270743,0
2334,2337,2337,2317,2322,2311,2314,2332,2327,2326,2334,2322,2320,2335,2331,-3,-1,8.559038664309378,0
2337,2337,2317,2322,2311,2314,2332,2327,2326,2334,2322,2320,2335,2331,2322,-15,-5,8.376838817324144,0
2337,2317,2322,2311,2314,2332,2327,2326,2334,2322,2320,2335,2331,2322,2329,-8,3,7.85099326442809,0
2317,2322,2311,2314,2332,2327,2326,2334,2322,2320,2335,2331,2322,2329,2329,12,-5,7.2453597629957684,0
2322,2311,2314,2332,2327,2326,2334,2322,2320,2335,2331,2322,2329,2329,2337,15,15,7.554248252914824,0
2311,2314,2332,2327,2326,2334,2322,2320,2335,2331,2322,2329,2329,2337,2343,32,23,8.6178110136314,0
2314,2332,2327,2326,2334,2322,2320,2335,2331,2322,2329,2329,2337,2343,2330,16,-5,7.323803331473015,0
2332,2327,2326,2334,2322,2320,2335,2331,2322,2329,2329,2337,2343,2330,2317,-15,-14,6.922702472575976,0
2327,2326,2334,2322,2320,2335,2331,2322,2329,2329,2337,2343,2330,2317,2324,-3,2,6.977514907595274,0
2326,2334,2322,2320,2335,2331,2322,2329,2329,2337,2343,2330,2317,2324,2331,5,2,6.996597812678742,0
2334,2322,2320,2335,2331,2322,2329,2329,2337,2343,2330,2317,2324,2331,2296,-38,-33,10.971825389649272,0
2322,2320,2335,2331,2322,2329,2329,2337,2343,2330,2317,2324,2331,2296,2292,-30,-45,13.927704490724679,0
2320,2335,2331,2322,2329,2329,2337,2343,2330,2317,2324,2331,2296,2292,2314,-6,-29,14.155597916759023,0
2335,2331,2322,2329,2329,2337,2343,2330,2317,2324,2331,2296,2292,2314,2331,-4,1,14.255157796724799,0
2331,2322,2329,2329,2337,2343,2330,2317,2324,2331,2296,2292,2314,2331,2320,-11,3,13.956394677027172,0
2322,2329,2329,2337,2343,2330,2317,2324,2331,2296,2292,2314,2331,2320,2329,7,5,13.884558054938314,0
2329,2329,2337,2343,2330,2317,2324,2331,2296,2292,2314,2331,2320,2329,2316,-13,-15,13.999319711362848,0
2329,2337,2343,2330,2317,2324,2331,2296,2292,2314,2331,2320,2329,2316,2325,-4,29,13.90512067377989,0
2337,2343,2330,2317,2324,2331,2296,2292,2314,2331,2320,2329,2316,2325,2329,-8,37,13.90512067377989,0
2343,2330,2317,2324,2331,2296,2292,2314,2331,2320,2329,2316,2325,2329,2318,-25,4,13.320231658217187,0
2330,2317,2324,2331,2296,2292,2314,2331,2320,2329,2316,2325,2329,2318,2311,-19,-20,12.046734392515239,0
2317,2324,2331,2296,2292,2314,2331,2320,2329,2316,2325,2329,2318,2311,2330,13,10,12.046734392515239,0
2324,2331,2296,2292,2314,2331,2320,2329,2316,2325,2329,2318,2311,2330,2321,-3,-8,12.046734392515239,0
2331,2296,2292,2314,2331,2320,2329,2316,2325,2329,2318,2311,2330,2321,2311,-20,-5,12.138878900144814,0
2296,2292,2314,2331,2320,2329,2316,2325,2329,2318,2311,2330,2321,2311,2331,35,6,12.138878900144814,0
2292,2314,2331,2320,2329,2316,2325,2329,2318,2311,2330,2321,2311,2331,2327,35,-2,10.62118278769007,0
2314,2331,2320,2329,2316,2325,2329,2318,2311,2330,2321,2311,2331,2327,2332,18,14,7.587583842794,0
2331,2320,2329,2316,2325,2329,2318,2311,2330,2321,2311,2331,2327,2332,2320,-11,9,7.228910212275627,0
2320,2329,2316,2325,2329,2318,2311,2330,2321,2311,2331,2327,2332,2320,2339,19,9,8.075241408745859,0
2329,2316,2325,2329,2318,2311,2330,2321,2311,2331,2327,2332,2320,2339,2333,4,12,8.31693624909008,0
2316,2325,2329,2318,2311,2330,2321,2311,2331,2327,2332,2320,2339,2333,2313,-3,2,8.754318662128723,0
2325,2329,2318,2311,2330,2321,2311,2331,2327,2332,2320,2339,2333,2313,2323,-2,-8,8.495376894018804,0
2329,2318,2311,2330,2321,2311,2331,2327,2332,2320,2339,2333,2313,2323,2309,-20,-18,9.349306060319334,0
2318,2311,2330,2321,2311,2331,2327,2332,2320,2339,2333,2313,2323,2309,2294,-24,-38,11.821288303008988,0
2311,2330,2321,2311,2331,2327,2332,2320,2339,2333,2313,2323,2309,2294,2308,-3,-12,12.264156057777633,0
2330,2321,2311,2331,2327,2332,2320,2339,2333,2313,2323,2309,2294,2308,2324,-6,-15,12.029725088890673,0
2321,2311,2331,2327,2332,2320,2339,2333,2313,2323,2309,2294,2308,2324,2324,3,-9,11.806777714516354,0
2311,2331,2327,2332,2320,2339,2333,2313,2323,2309,2294,2308,2324,2324,2345,34,32,13.38549321360362,0
2331,2327,2332,2320,2339,2333,2313,2323,2309,2294,2308,2324,2324,2345,2335,4,12,13.38549321360362,0
2327,2332,2320,2339,2333,2313,2323,2309,2294,2308,2324,2324,2345,2335,2314,-13,5,13.451854182690985,0
2332,2320,2339,2333,2313,2323,2309,2294,2308,2324,2324,2345,2335,2314,2327,-5,33,13.451854182690985,0
2320,2339,2333,2313,2323,2309,2294,2308,2324,2324,2345,2335,2314,2327,2323,3,15,13.204256168083871,0
2339,2333,2313,2323,2309,2294,2308,2324,2324,2345,2335,2314,2327,2323,2347,8,23,14.662228765810209,0
2333,2313,2323,2309,2294,2308,2324,2324,2345,2335,2314,2327,2323,2347,2320,-13,-4,14.070232001336317,0
2313,2323,2309,2294,2308,2324,2324,2345,2335,2314,2327,2323,2347,2320,2327,14,-18,13.836803924936671,0
2323,2309,2294,2308,2324,2324,2345,2335,2314,2327,2323,2347,2320,2327,2333,10,-2,13.850562993542725,0
2309,2294,2308,2324,2324,2345,2335,2314,2327,2323,2347,2320,2327,2333,2338,29,24,14.3420792807472,0
2294,2308,2324,2324,2345,2335,2314,2327,2323,2347,2320,2327,2333,2338,2340,46,13,14.176439206353216,0
2308,2324,2324,2345,2335,2314,2327,2323,2347,2320,2327,2333,2338,2340,2343,35,20,11.525540995462869,0
2324,2324,2345,2335,2314,2327,2323,2347,2320,2327,2333,2338,2340,2343,2343,19,-4,10.255312212284352,0
2324,2345,2335,2314,2327,2323,2347,2320,2327,2333,2338,2340,2343,2343,2336,12,16,10.035650736961989,0
2345,2335,2314,2327,2323,2347,2320,2327,2333,2338,2340,2343,2343,2336,2354,9,27,11.051825964195109,0
2335,2314,2327,2323,2347,2320,2327,2333,2338,2340,2343,2343,2336,2354,2329,-6,-4,10.78667608452117,0
2314,2327,2323,2347,2320,2327,2333,2338,2340,2343,2343,2336,2354,2329,2336,22,-2,10.796824930109247,0
2327,2323,2347,2320,2327,2333,2338,2340,2343,2343,2336,2354,2329,2336,2337,10,-3,9.280291456835261,0
2323,2347,2320,2327,2333,2338,2340,2343,2343,2336,2354,2329,2336,2337,2332,9,-11,9.038541812440661,0
2347,2320,2327,2333,2338,2340,2343,2343,2336,2354,2329,2336,2337,2332,2341,-6,-2,8.379112352124407,0
2320,2327,2333,2338,2340,2343,2343,2336,2354,2329,2336,2337,2332,2341,2336,16,0,7.916228058025278,0
2327,2333,2338,2340,2343,2343,2336,2354,2329,2336,2337,2332,2341,2336,2351,24,-3,7.37563556583431,0
2333,2338,2340,2343,2343,2336,2354,2329,2336,2337,2332,2341,2336,2351,2319,-14,-10,8.467304062996563,0
2338,2340,2343,2343,2336,2354,2329,2336,2337,2332,2341,2336,2351,2319,2351,13,15,8.987822449345135,0
2340,2343,2343,2336,2354,2329,2336,2337,2332,2341,2336,2351,2319,2351,2327,-13,-10,9.514400113712346,0
2343,2343,2336,2354,2329,2336,2337,2332,2341,2336,2351,2319,2351,2327,2327,-16,-5,9.934547704613335,0
2343,2336,2354,2329,2336,2337,2332,2341,2336,2351,2319,2351,2327,2327,2342,-1,1,9.898051756352286,0
2336,2354,2329,2336,2337,2332,2341,2336,2351,2319,2351,2327,2327,2342,2325,-11,-11,10.255312212284352,0
2354,2329,2336,2337,2332,2341,2336,2351,2319,2351,2327,2327,2342,2325,2331,-23,-20,10.343159690392119,0
2329,2336,2337,2332,2341,2336,2351,2319,2351,2327,2327,2342,2325,2331,2343,14,24,9.303353210127032,0
2336,2337,2332,2341,2336,2351,2319,2351,2327,2327,2342,2325,2331,2343,2345,9,-6,9.465727652959385,0
2337,2332,2341,2336,2351,2319,2351,2327,2327,2342,2325,2331,2343,2345,2325,-12,-2,9.898532839817848,0
2332,2341,2336,2351,2319,2351,2327,2327,2342,2325,2331,2343,2345,2325,2335,3,8,9.889869756954528,0
2341,2336,2351,2319,2351,2327,2327,2342,2325,2331,2343,2345,2325,2335,2327,-14,-15,10.09242997781718,0
2336,2351,2319,2351,2327,2327,2342,2325,2331,2343,2345,2325,2335,2327,2344,8,19,10.248344814094198,0
2351,2319,2351,2327,2327,2342,2325,2331,2343,2345,2325,2335,2327,2344,2325,-26,-6,10.57535319684857,0
2319,2351,2327,2327,2342,2325,2331,2343,2345,2325,2335,2327,2344,2325,2335,16,-8,9.54538033366328,0
2351,2327,2327,2342,2325,2331,2343,2345,2325,2335,2327,2344,2325,2335,2320,-31,-25,9.440540743188894,0
2327,2327,2342,2325,2331,2343,2345,2325,2335,2327,2344,2325,2335,2320,2345,18,20,8.746155618055175,0
2327,2342,2325,2331,2343,2345,2325,2335,2327,2344,2325,2335,2320,2345,2327,0,-8,8.746155618055175,0
2342,2325,2331,2343,2345,2325,2335,2327,2344,2325,2335,2320,2345,2327,2312,-30,-15,10.222291235101752,0
2325,2331,2343,2345,2325,2335,2327,2344,2325,2335,2320,2345,2327,2312,2339,14,-5,10.041817327460963,0
2331,2343,2345,2325,2335,2327,2344,2325,2335,2320,2345,2327,2312,2339,2354,23,29,11.333893543577284,0
2343,2345,2325,2335,2327,2344,2325,2335,2320,2345,2327,2312,2339,2354,2332,-11,-3,11.31917883610863,0
2345,2325,2335,2327,2344,2325,2335,2320,2345,2327,2312,2339,2354,2332,2334,-11,14,11.035440742487468,0
2325,2335,2327,2344,2325,2335,2320,2345,2327,2312,2339,2354,2332,2334,2322,-3,-23,10.885551804811646,0
2335,2327,2344,2325,2335,2320,2345,2327,2312,2339,2354,2332,2334,2322,2330,-5,3,10.740222574620182,0
2327,2344,2325,2335,2320,2345,2327,2312,2339,2354,2332,2334,2322,2330,2339,12,27,10.867163295692123,0
2344,2325,2335,2320,2345,2327,2312,2339,2354,2332,2334,2322,2330,2339,2338,-6,-1,10.852693323823003,0
2325,2335,2320,2345,2327,2312,2339,2354,2332,2334,2322,2330,2339,2338,2324,-1,-30,10.639996419619878,0
2335,2320,2345,2327,2312,2339,2354,2332,2334,2322,2330,2339,2338,2324,2341,6,9,10.718475371325638,0
2320,2345,2327,2312,2339,2354,2332,2334,2322,2330,2339,2338,2324,2341,2338,18,4,10.790207200446682,0
2345,2327,2312,2339,2354,2332,2334,2322,2330,2339,2338,2324,2341,2338,2327,-18,5,10.329338705611221,0
2327,2312,2339,2354,2332,2334,2322,2330,2339,2338,2324,2341,2338,2327,2335,8,5,9.84305411372478,0
2312,2339,2354,2332,2334,2322,2330,2339,2338,2324,2341,2338,2327,2335,2318,6,-21,10.475822504360082,0
2339,2354,2332,2334,2322,2330,2339,2338,2324,2341,2338,2327,2335,2318,2337,-2,-1,8.903182951431845,0
2354,2332,2334,2322,2330,2339,2338,2324,2341,2338,2327,2335,2318,2337,2339,-15,15,8.903182951431845,0
2332,2334,2322,2330,2339,2338,2324,2341,2338,2327,2335,2318,2337,2339,2333,1,-8,6.947421584060281,0
2334,2322,2330,2339,2338,2324,2341,2338,2327,2335,2318,2337,2339,2333,2340,6,2,7.211102550927978,0
2322,2330,2339,2338,2324,2341,2338,2327,2335,2318,2337,2339,2333,2340,2331,9,4,7.222979203308602,0
2330,2339,2338,2324,2341,2338,2327,2335,2318,2337,2339,2333,2340,2331,2346,16,11,7.317298486658662,0
2339,2338,2324,2341,2338,2327,2335,2318,2337,2339,2333,2340,2331,2346,2358,19,40,9.391992536705073,0
2338,2324,2341,2338,2327,2335,2318,2337,2339,2333,2340,2331,2346,2358,2356,18,19,10.682428830293498,0
2324,2341,2338,2327,2335,2318,2337,2339,2333,2340,2331,2346,2358,2356,2276,-48,-63,19.106717841289925,0
2341,2338,2327,2335,2318,2337,2339,2333,2340,2331,2346,2358,2356,2276,2307,-34,-26,20.170227942145207,0
2338,2327,2335,2318,2337,2339,2333,2340,2331,2346,2358,2356,2276,2307,2321,-17,-19,20.203252920542983,0
2327,2335,2318,2337,2339,2333,2340,2331,2346,2358,2356,2276,2307,2321,2314,-13,-17,20.539856725053227,0
2335,2318,2337,2339,2333,2340,2331,2346,2358,2356,2276,2307,2321,2314,2322,-13,-24,20.61853073145149,0
2318,2337,2339,2333,2340,2331,2346,2358,2356,2276,2307,2321,2314,2322,2357,39,-1,21.83269719175042,0
2337,2339,2333,2340,2331,2346,2358,2356,2276,2307,2321,2314,2322,2357,2341,4,-15,21.71196729477833,0
2339,2333,2340,2331,2346,2358,2356,2276,2307,2321,2314,2322,2357,2341,2369,30,93,23.73063119984079,0
2333,2340,2331,2346,2358,2356,2276,2307,2321,2314,2322,2357,2341,2369,2358,25,51,24.51083336773665,0
2340,2331,2346,2358,2356,2276,2307,2321,2314,2322,2357,2341,2369,2358,2371,31,50,26.167591733723935,0
2331,2346,2358,2356,2276,2307,2321,2314,2322,2357,2341,2369,2358,2371,2345,14,31,26.229391002860748,0
2346,2358,2356,2276,2307,2321,2314,2322,2357,2341,2369,2358,2371,2345,2346,0,24,26.22394398436738,0
2358,2356,2276,2307,2321,2314,2322,2357,2341,2369,2358,2371,2345,2346,2353,-5,-4,26.416445094459085,0
2356,2276,2307,2321,2314,2322,2357,2341,2369,2358,2371,2345,2346,2353,2349,-7,8,26.068590843607726,0
2276,2307,2321,2314,2322,2357,2341,2369,2358,2371,2345,2346,2353,2349,2328,52,-41,25.765055700271546,0
2307,2321,2314,2322,2357,2341,2369,2358,2371,2345,2346,2353,2349,2328,2290,-17,-68,23.55075572541347,0
2321,2314,2322,2357,2341,2369,2358,2371,2345,2346,2353,2349,2328,2290,2305,-16,-66,23.744071941875355,0
2314,2322,2357,2341,2369,2358,2371,2345,2346,2353,2349,2328,2290,2305,2304,-10,-41,24.98342307554008,0
2322,2357,2341,2369,2358,2371,2345,2346,2353,2349,2328,2290,2305,2304,2319,-3,-27,24.689114624716314,0
2357,2341,2369,2358,2371,2345,2346,2353,2349,2328,2290,2305,2304,2319,2305,-52,-48,25.798671062119237,0
2341,2369,2358,2371,2345,2346,2353,2349,2328,2290,2305,2304,2319,2305,2279,-62,-70,28.93391485042127,0
2369,2358,2371,2345,2346,2353,2349,2328,2290,2305,2304,2319,2305,2279,2299,-70,-29,29.89266512995167,0
2358,2371,2345,2346,2353,2349,2328,2290,2305,2304,2319,2305,2279,2299,2277,-81,-13,30.31469861933238,0
2371,2345,2346,2353,2349,2328,2290,2305,2304,2319,2305,2279,2299,2277,2283,-88,-22,30.113752593094326,0
2345,2346,2353,2349,2328,2290,2305,2304,2319,2305,2279,2299,2277,2283,2287,-58,-17,26.974767751328187,0
2346,2353,2349,2328,2290,2305,2304,2319,2305,2279,2299,2277,2283,2287,2301,-45,-18,25.39028685672272,0
2353,2349,2328,2290,2305,2304,2319,2305,2279,2299,2277,2283,2287,2301,2297,-56,-8,23.260839767013284,0
2349,2328,2290,2305,2304,2319,2305,2279,2299,2277,2283,2287,2301,2297,2305,-44,26,19.13062864573332,0
2328,2290,2305,2304,2319,2305,2279,2299,2277,2283,2287,2301,2297,2305,2306,-22,7,14.132030488018547,0
2290,2305,2304,2319,2305,2279,2299,2277,2283,2287,2301,2297,2305,2306,2301,11,24,11.681487185163663,0
2305,2304,2319,2305,2279,2299,2277,2283,2287,2301,2297,2305,2306,2301,2299,-6,16,11.515207336387824,0
2304,2319,2305,2279,2299,2277,2283,2287,2301,2297,2305,2306,2301,2299,2278,-26,-9,12.386628735397352,0
2319,2305,2279,2299,2277,2283,2287,2301,2297,2305,2306,2301,2299,2278,2284,-35,-17,12.53946152105804,0
2305,2279,2299,2277,2283,2287,2301,2297,2305,2306,2301,2299,2278,2284,2290,-15,-7,10.606377237079496,2
2279,2299,2277,2283,2287,2301,2297,2305,2306,2301,2299,2278,2284,2290,2069,-210,-236,58.412327466040935,2
2299,2277,2283,2287,2301,2297,2305,2306,2301,2299,2278,2284,2290,2069,2075,-224,-231,78.28227312562076,2
2277,2283,2287,2301,2297,2305,2306,2301,2299,2278,2284,2290,2069,2075,2087,-190,-214,89.70066623949637,2
2283,2287,2301,2297,2305,2306,2301,2299,2278,2284,2290,2069,2075,2087,2091,-192,-208,98.05965142756341,2
2287,2301,2297,2305,2306,2301,2299,2278,2284,2290,2069,2075,2087,2091,2095,-192,-183,103.59996322852814,2
2301,2297,2305,2306,2301,2299,2278,2284,2290,2069,2075,2087,2091,2095,2091,-210,-193,107.42137767200894,2
2297,2305,2306,2301,2299,2278,2284,2290,2069,2075,2087,2091,2095,2091,2086,-211,-204,108.92623104433481,2
2305,2306,2301,2299,2278,2284,2290,2069,2075,2087,2091,2095,2091,2086,2082,-223,13,108.96382099446717,2
2306,2301,2299,2278,2284,2290,2069,2075,2087,2091,2095,2091,2086,2082,2079,-227,4,106.42560558347564,2
2301,2299,2278,2284,2290,2069,2075,2087,2091,2095,2091,2086,2082,2079,2079,-222,-8,101.34791561744129,2
2299,2278,2284,2290,2069,2075,2087,2091,2095,2091,2086,2082,2079,2079,2081,-218,-10,93.95627149041702,2
2278,2284,2290,2069,2075,2087,2091,2095,2091,2086,2082,2079,2079,2081,2088,-190,-7,83.27550374395537,2
2284,2290,2069,2075,2087,2091,2095,2091,2086,2082,2079,2079,2081,2088,2093,-191,2,71.6775185582388,2
2290,2069,2075,2087,2091,2095,2091,2086,2082,2079,2079,2081,2088,2093,2098,-192,12,53.44218059423349,2
2069,2075,2087,2091,2095,2091,2086,2082,2079,2079,2081,2088,2093,2098,2100,31,18,8.754318662128723,0
2075,2087,2091,2095,2091,2086,2082,2079,2079,2081,2088,2093,2098,2100,2097,22,18,7.735508725229081,0
2087,2091,2095,2091,2086,2082,2079,2079,2081,2088,2093,2098,2100,2097,2094,7,15,6.9467361298053385,0
2091,2095,2091,2086,2082,2079,2079,2081,2088,2093,2098,2100,2097,2094,2088,-3,7,6.926828450377011,0
2095,2091,2086,2082,2079,2079,2081,2088,2093,2098,2100,2097,2094,2088,2084,-11,-4,7.050835816716038,0
2091,2086,2082,2079,2079,2081,2088,2093,2098,2100,2097,2094,2088,2084,2082,-9,-11,7.059610133576446,0
2086,2082,2079,2079,2081,2088,2093,2098,2100,2097,2094,2088,2084,2082,2081,-5,-17,7.2394422305536645,0
2082,2079,2079,2081,2088,2093,2098,2100,2097,2094,2088,2084,2082,2081,2089,7,-11,7.237468644557459,0
2079,2079,2081,2088,2093,2098,2100,2097,2094,2088,2084,2082,2081,2089,2093,14,-4,7.179335424874446,0
2079,2081,2088,2093,2098,2100,2097,2094,2088,2084,2082,2081,2089,2093,2101,22,7,7.366591251499344,0
2081,2088,2093,2098,2100,2097,2094,2088,2084,2082,2081,2089,2093,2101,2100,19,12,7.146094504459528,0
2088,2093,2098,2100,2097,2094,2088,2084,2082,2081,2089,2093,2101,2100,2101,13,17,6.957010852370434,0
2093,2098,2100,2097,2094,2088,2084,2082,2081,2089,2093,2101,2100,2101,2097,4,15,6.919950453992737,0
2098,2100,2097,2094,2088,2084,2082,2081,2089,2093,2101,2100,2101,2097,2089,-9,8,7.004760286167305,0
2100,2097,2094,2088,2084,2082,2081,2089,2093,2101,2100,2101,2097,2089,2084,-16,-5,7.211102550927978,0
2097,2094,2088,2084,2082,2081,2089,2093,2101,2100,2101,2097,2089,2084,2083,-14,-10,7.199867723652654,0
2094,2088,2084,2082,2081,2089,2093,2101,2100,2101,2097,2089,2084,2083,2084,-10,-17,7.191264542087554,0
2088,2084,2082,2081,2089,2093,2101,2100,2101,2097,2089,2084,2083,2084,2087,-1,-13,7.140094703920417,0
2084,2082,2081,2089,2093,2101,2100,2101,2097,2089,2084,2083,2084,2087,2094,10,-7,7.215723571941116,0
2082,2081,2089,2093,2101,2100,2101,2097,2089,2084,2083,2084,2087,2094,2099,17,2,7.372406727275765,0
2081,2089,2093,2101,2100,2101,2097,2089,2084,2083,2084,2087,2094,2099,2103,22,14,7.546680127869536,0
2089,2093,2101,2100,2101,2097,2089,2084,2083,2084,2087,2094,2099,2103,2102,13,18,7.235494520237089,0
2093,2101,2100,2101,2097,2089,2084,2083,2084,2087,2094,2099,2103,2102,2097,4,14,7.156082993476516,0
2101,2100,2101,2097,2089,2084,2083,2084,2087,2094,2099,2103,2102,2097,2092,-9,8,7.173363427092124,0
2100,2101,2097,2089,2084,2083,2084,2087,2094,2099,2103,2102,2097,2092,2085,-15,-2,7.27880157587445,0
2101,2097,2089,2084,2083,2084,2087,2094,2099,2103,2102,2097,2092,2085,2084,-17,-10,7.372406727275765,0
2097,2089,2084,2083,2084,2087,2094,2099,2103,2102,2097,2092,2085,2084,2085,-12,-14,7.14142842854285,0
2089,2084,2083,2084,2087,2094,2099,2103,2102,2097,2092,2085,2084,2085,2087,-2,-16,7.006799418795866,0
2084,2083,2084,2087,2094,2099,2103,2102,2097,2092,2085,2084,2085,2087,2097,13,-5,7.199867723652654,0
2083,2084,2087,2094,2099,2103,2102,2097,2092,2085,2084,2085,2087,2097,2101,18,4,7.377572190671632,0
2084,2087,2094,2099,2103,2102,2097,2092,2085,2084,2085,2087,2097,2101,2104,20,12,7.538472751729718,0
2087,2094,2099,2103,2102,2097,2092,2085,2084,2085,2087,2097,2101,2104,2103,16,18,7.441837970619381,0
2094,2099,2103,2102,2097,2092,2085,2084,2085,2087,2097,2101,2104,2103,2098,4,14,7.1693793315739685,0
2099,2103,2102,2097,2092,2085,2084,2085,2087,2097,2101,2104,2103,2098,2092,-7,7,7.215723571941116,0
2103,2102,2097,2092,2085,2084,2085,2087,2097,2101,2104,2103,2098,2092,2086,-17,-1,7.5099933422074345,0
2102,2097,2092,2085,2084,2085,2087,2097,2101,2104,2103,2098,2092,2086,2084,-18,-13,7.558029473600214,0
2097,2092,2085,2084,2085,2087,2097,2101,2104,2103,2098,2092,2086,2084,2086,-11,-15,7.3432832931740775,0
2092,2085,2084,2085,2087,2097,2101,2104,2103,2098,2092,2086,2084,2086,2089,-3,-15,7.249302101056415,0
2085,2084,2085,2087,2097,2101,2104,2103,2098,2092,2086,2084,2086,2089,2093,8,-10,7.258492562902734,0
2084,2085,2087,2097,2101,2104,2103,2098,2092,2086,2084,2086,2089,2093,2100,16,2,7.317298486658662,0
2085,2087,2097,2101,2104,2103,2098,2092,2086,2084,2086,2089,2093,2100,2105,20,13,7.559289460184544,0
2087,2097,2101,2104,2103,2098,2092,2086,2084,2086,2089,2093,2100,2105,2101,14,15,7.323803331473015,0
2097,2101,2104,2103,2098,2092,2086,2084,2086,2089,2093,2100,2105,2101,2098,1,14,7.0020405189181405,0
2101,2104,2103,2098,2092,2086,2084,2086,2089,2093,2100,2105,2101,2098,2092,-9,6,7.059610133576446,0
2104,2103,2098,2092,2086,2084,2086,2089,2093,2100,2105,2101,2098,2092,2087,-17,-2,7.199867723652654,0
2103,2098,2092,2086,2084,2086,2089,2093,2100,2105,2101,2098,2092,2087,2083,-20,-10,7.268981719477305,0
2098,2092,2086,2084,2086,2089,2093,2100,2105,2101,2098,2092,2087,2083,2083,-15,-17,7.163399033579361,0
2092,2086,2084,2086,2089,2093,2100,2105,2101,2098,2092,2087,2083,2083,2089,-3,-16,6.981608492522131,0
2086,2084,2086,2089,2093,2100,2105,2101,2098,2092,2087,2083,2083,2089,2096,10,-5,7.0898989179442236,0
2084,2086,2089,2093,2100,2105,2101,2098,2092,2087,2083,2083,2089,2096,2101,17,3,7.3179492313339365,0
2086,2089,2093,2100,2105,2101,2098,2092,2087,2083,2083,2089,2096,2101,2103,17,11,7.391758602531284,0
2089,2093,2100,2105,2101,2098,2092,2087,2083,2083,2089,2096,2101,2103,2102,13,15,7.350413010747861,0
2093,2100,2105,2101,2098,2092,2087,2083,2083,2089,2096,2101,2103,2102,2098,5,15,7.2091212065985255,0
2100,2105,2101,2098,2092,2087,2083,2083,2089,2096,2101,2103,2102,2098,2094,-6,11,7.189940062005948,0
2105,2101,2098,2092,2087,2083,2083,2089,2096,2101,2103,2102,2098,2094,2089,-16,0,7.255211591545435,0
2101,2098,2092,2087,2083,2083,2089,2096,2101,2103,2102,2098,2094,2089,2084,-17,-12,7.158079018709925,0
2098,2092,2087,2083,2083,2089,2096,2101,2103,2102,2098,2094,2089,2084,2085,-13,-16,7.1260755245052225,0
2092,2087,2083,2083,2089,2096,2101,2103,2102,2098,2094,2089,2084,2085,2086,-6,-17,7.110019757523951,0
2087,2083,2083,2089,2096,2101,2103,2102,2098,2094,2089,2084,2085,2086,2095,8,-7,7.168050807643064,0
2083,2083,2089,2096,2101,2103,2102,2098,2094,2089,2084,2085,2086,2095,2101,18,3,7.423899629863386,0
2083,2089,2096,2101,2103,2102,2098,2094,2089,2084,2085,2086,2095,2101,2102,19,8,7.288608202106183,0
2089,2096,2101,2103,2102,2098,2094,2089,2084,2085,2086,2095,2101,2102,2104,15,15,7.065678277689235,0
2096,2101,2103,2102,2098,2094,2089,2084,2085,2086,2095,2101,2102,2104,2101,5,17,6.984336216202108,0
2101,2103,2102,2098,2094,2089,2084,2085,2086,2095,2101,2102,2104,2101,2095,-6,10,6.98978847012861,0
2103,2102,2098,2094,2089,2084,2085,2086,2095,2101,2102,2104,2101,2095,2087,-16,1,7.205817755384154,0
2102,2098,2094,2089,2084,2085,2086,2095,2101,2102,2104,2101,2095,2087,2086,-16,-9,7.205817755384154,0
2098,2094,2089,2084,2085,2086,2095,2101,2102,2104,2101,2095,2087,2086,2085,-13,-16,7.183313998427188,0
2094,2089,2084,2085,2086,2095,2101,2102,2104,2101,2095,2087,2086,2085,2090,-4,-12,7.065678277689235,0
2089,2084,2085,2086,2095,2101,2102,2104,2101,2095,2087,2086,2085,2090,2095,6,-9,7.087883692477977,0
2084,2085,2086,2095,2101,2102,2104,2101,2095,2087,2086,2085,2090,2095,2101,17,0,7.356888576280705,0
2085,2086,2095,2101,2102,2104,2101,2095,2087,2086,2085,2090,2095,2101,2104,19,9,7.39562290109752,0
2086,2095,2101,2102,2104,2101,2095,2087,2086,2085,2090,2095,2101,2104,2105,19,18,7.369822637912375,0
2095,2101,2102,2104,2101,2095,2087,2086,2085,2090,2095,2101,2104,2105,2100,5,14,6.912376753400554,0
2101,2102,2104,2101,2095,2087,2086,2085,2090,2095,2101,2104,2105,2100,2096,-5,11,6.899275324264136,0
2102,2104,2101,2095,2087,2086,2085,2090,2095,2101,2104,2105,2100,2096,2091,-11,1,6.947421584060281,0
2104,2101,2095,2087,2086,2085,2090,2095,2101,2104,2105,2100,2096,2091,2086,-18,-9,7.205817755384154,0
2101,2095,2087,2086,2085,2090,2095,2101,2104,2105,2100,2096,2091,2086,2088,-13,-13,6.969320524371696,0
2095,2087,2086,2085,2090,2095,2101,2104,2105,2100,2096,2091,2086,2088,2090,-5,-14,6.755597326520819,0
2087,2086,2085,2090,2095,2101,2104,2105,2100,2096,2091,2086,2088,2090,2098,11,-7,6.854265269228525,0
2086,2085,2090,2095,2101,2104,2105,2100,2096,2091,2086,2088,2090,2098,2104,18,4,7.10934998033274,0
2085,2090,2095,2101,2104,2105,2100,2096,2091,2086,2088,2090,2098,2104,2108,23,12,7.468664698656138,0
2090,2095,2101,2104,2105,2100,2096,2091,2086,2088,2090,2098,2104,2108,2105,15,14,7.129415924784542,0
2095,2101,2104,2105,2100,2096,2091,2086,2088,2090,2098,2104,2108,2105,2103,8,17,6.95358763174672,0
2101,2104,2105,2100,2096,2091,2086,2088,2090,2098,2104,2108,2105,2103,2100,-1,12,6.905484362860746,0
2104,2105,2100,2096,2091,2086,2088,2090,2098,2104,2108,2105,2103,2100,2095,-9,5,6.930264888773836,0
2105,2100,2096,2091,2086,2088,2090,2098,2104,2108,2105,2103,2100,2095,2095,-10,-3,6.780223342296961,0
2100,2096,2091,2086,2088,2090,2098,2104,2108,2105,2103,2100,2095,2095,2095,-5,-9,6.485882103975269,0
2096,2091,2086,2088,2090,2098,2104,2108,2105,2103,2100,2095,2095,2095,2099,3,-9,6.457184997755453,0
2091,2086,2088,2090,2098,2104,2108,2105,2103,2100,2095,2095,2095,2099,2113,22,8,7.671840904055744,0
2086,2088,2090,2098,2104,2108,2105,2103,2100,2095,2095,2095,2099,2113,2145,59,42,14.11584722420666,0
2088,2090,2098,2104,2108,2105,2103,2100,2095,2095,2095,2099,2113,2145,2148,60,48,17.814386909247844,0
2090,2098,2104,2108,2105,2103,2100,2095,2095,2095,2099,2113,2145,2148,2148,58,53,20.13336486910176,0
2098,2104,2108,2105,2103,2100,2095,2095,2095,2099,2113,2145,2148,2148,2149,51,54,21.70472847319768,0
2104,2108,2105,2103,2100,2095,2095,2095,2099,2113,2145,2148,2148,2149,2145,41,50,22.65328736787287,0
2108,2105,2103,2100,2095,2095,2095,2099,2113,2145,2148,2148,2149,2145,2148,40,49,23.70191874893154,0
2105,2103,2100,2095,2095,2095,2099,2113,2145,2148,2148,2149,2145,2148,2144,39,31,24.245372656201745,0
2103,2100,2095,2095,2095,2099,2113,2145,2148,2148,2149,2145,2148,2144,2145,42,0,24.425396619093007,0
2100,2095,2095,2095,2099,2113,2145,2148,2148,2149,2145,2148,2144,2145,2148,48,0,24.319891917053063,0
2095,2095,2095,2099,2113,2145,2148,2148,2149,2145,2148,2144,2145,2148,2147,52,-1,23.496098966991664,0
2095,2095,2099,2113,2145,2148,2148,2149,2145,2148,2144,2145,2148,2147,2150,55,1,21.711747972008148,0
2095,2099,2113,2145,2148,2148,2149,2145,2148,2144,2145,2148,2147,2150,2151,56,6,19.070046320517072,0
2099,2113,2145,2148,2148,2149,2145,2148,2144,2145,2148,2147,2150,2151,2151,52,3,15.03551351523009,0
2113,2145,2148,2148,2149,2145,2148,2144,2145,2148,2147,2150,2151,2151,2156,43,12,9.59067006944522,0
2145,2148,2148,2149,2145,2148,2144,2145,2148,2147,2150,2151,2151,2156,2149,4,4,3.0581662728473336,0
2148,2148,2149,2145,2148,2144,2145,2148,2147,2150,2151,2151,2156,2149,2150,2,2,2.9471535904520287,0
2148,2149,2145,2148,2144,2145,2148,2147,2150,2151,2151,2156,2149,2150,2141,-7,-6,3.542933946940156,0
2149,2145,2148,2144,2145,2148,2147,2150,2151,2151,2156,2149,2150,2141,2141,-8,-9,3.994043183589901,0
2145,2148,2144,2145,2148,2147,2150,2151,2151,2156,2149,2150,2141,2141,2136,-9,-15,4.974219249576475,0
2148,2144,2145,2148,2147,2150,2151,2151,2156,2149,2150,2141,2141,2136,2139,-9,-12,5.355904618802905,0
2144,2145,2148,2147,2150,2151,2151,2156,2149,2150,2141,2141,2136,2139,2144,0,-12,5.370111287310091,0
2145,2148,2147,2150,2151,2151,2156,2149,2150,2141,2141,2136,2139,2144,2138,-7,-11,5.750362307426086,0
2148,2147,2150,2151,2151,2156,2149,2150,2141,2141,2136,2139,2144,2138,2136,-12,-14,6.277700519260521,0
2147,2150,2151,2151,2156,2149,2150,2141,2141,2136,2139,2144,2138,2136,2132,-15,-9,7.065678277689235,0
2150,2151,2151,2156,2149,2150,2141,2141,2136,2139,2144,2138,2136,2132,2138,-12,-3,7.17999867356401,0
2151,2151,2156,2149,2150,2141,2141,2136,2139,2144,2138,2136,2132,2138,2128,-23,-8,7.955231881329059,0
2151,2156,2149,2150,2141,2141,2136,2139,2144,2138,2136,2132,2138,2128,2127,-24,-12,8.415971211248968,0
2156,2149,2150,2141,2141,2136,2139,2144,2138,2136,2132,2138,2128,2127,1969,-187,-175,44.76042044144847,0
2149,2150,2141,2141,2136,2139,2144,2138,2136,2132,2138,2128,2127,1969,2106,-43,-32,44.40795724492027,0
2150,2141,2141,2136,2139,2144,2138,2136,2132,2138,2128,2127,1969,2106,2113,-37,-23,43.985170661203966,0
2141,2141,2136,2139,2144,2138,2136,2132,2138,2128,2127,1969,2106,2113,2133,-8,1,43.44257293090664,0
2141,2136,2139,2144,2138,2136,2132,2138,2128,2127,1969,2106,2113,2133,2132,-9,-6,43.21408500543709,0
2136,2139,2144,2138,2136,2132,2138,2128,2127,1969,2106,2113,2133,2132,2131,-5,3,42.956567212321175,0
2139,2144,2138,2136,2132,2138,2128,2127,1969,2106,2113,2133,2132,2131,2128,-11,1,42.7948595043844,0
2144,2138,2136,2132,2138,2128,2127,1969,2106,2113,2133,2132,2131,2128,2122,-22,153,42.46825144684416,0
2138,2136,2132,2138,2128,2127,1969,2106,2113,2133,2132,2131,2128,2122,2112,-26,6,41.89385680616238,0
2136,2132,2138,2128,2127,1969,2106,2113,2133,2132,2131,2128,2122,2112,2115,-21,2,41.46289218773129,0
2132,2138,2128,2127,1969,2106,2113,2133,2132,2131,2128,2122,2112,2115,2117,-15,-16,41.057219074058565,0
2138,2128,2127,1969,2106,2113,2133,2132,2131,2128,2122,2112,2115,2117,2103,-35,-29,40.80756232436756,0
2128,2127,1969,2106,2113,2133,2132,2131,2128,2122,2112,2115,2117,2103,2105,-23,-26,40.16715075780208,0
2127,1969,2106,2113,2133,2132,2131,2128,2122,2112,2115,2117,2103,2105,2097,-30,-31,39.93864341831402,0
1969,2106,2113,2133,2132,2131,2128,2122,2112,2115,2117,2103,2105,2097,2016,47,-106,45.87633480606418,0
2106,2113,2133,2132,2131,2128,2122,2112,2115,2117,2103,2105,2097,2016,2098,-8,-14,28.304130608867133,0
2113,2133,2132,2131,2128,2122,2112,2115,2117,2103,2105,2097,2016,2098,2118,5,3,28.396847578225163,0
2133,2132,2131,2128,2122,2112,2115,2117,2103,2105,2097,2016,2098,2118,2119,-14,2,28.49427678541446,0
2132,2131,2128,2122,2112,2115,2117,2103,2105,2097,2016,2098,2118,2119,2120,-12,17,27.92813907837313,0
2131,2128,2122,2112,2115,2117,2103,2105,2097,2016,2098,2118,2119,2120,2118,-13,13,27.327293176986124,0
2128,2122,2112,2115,2117,2103,2105,2097,2016,2098,2118,2119,2120,2118,2117,-11,20,26.715431602620342,0
2122,2112,2115,2117,2103,2105,2097,2016,2098,2118,2119,2120,2118,2117,2119,-3,103,26.308065031740473,0
2112,2115,2117,2103,2105,2097,2016,2098,2118,2119,2120,2118,2117,2119,2118,6,20,26.158491291866714,0
2115,2117,2103,2105,2097,2016,2098,2118,2119,2120,2118,2117,2119,2118,2118,3,0,26.300099583371125,1
2117,2103,2105,2097,2016,2098,2118,2119,2120,2118,2117,2119,2118,2118,2121,4,2,26.483058376108694,1
2103,2105,2097,2016,2098,2118,2119,2120,2118,2117,2119,2118,2118,2121,2119,16,-1,26.542329176152535,1
2105,2097,2016,2098,2118,2119,2120,2118,2117,2119,2118,2118,2121,2119,2118,13,0,26.660475471771925,1
2097,2016,2098,2118,2119,2120,2118,2117,2119,2118,2118,2121,2119,2118,2118,21,1,26.76476005781447,1
2016,2098,2118,2119,2120,2118,2117,2119,2118,2118,2121,2119,2118,2118,2116,100,-3,26.608806275903685,1
2098,2118,2119,2120,2118,2117,2119,2118,2118,2121,2119,2118,2118,2116,2117,19,-1,5.378086046523384,1
2118,2119,2120,2118,2117,2119,2118,2118,2121,2119,2118,2118,2116,2117,2118,0,0,1.2227992865708155,1
2119,2120,2118,2117,2119,2118,2118,2121,2119,2118,2118,2116,2117,2118,2117,-2,-4,1.2649110640673518,1
2120,2118,2117,2119,2118,2118,2121,2119,2118,2118,2116,2117,2118,2117,2118,-2,-1,1.245945806357946,1
2118,2117,2119,2118,2118,2121,2119,2118,2118,2116,2117,2118,2117,2118,2117,-1,-1,1.162919151265879,1
2117,2119,2118,2118,2121,2119,2118,2118,2116,2117,2118,2117,2118,2117,2120,3,2,1.2798809468443688,1
2119,2118,2118,2121,2119,2118,2118,2116,2117,2118,2117,2118,2117,2120,2121,2,5,1.4474937289114918,1
2118,2118,2121,2119,2118,2118,2116,2117,2118,2117,2118,2117,2120,2121,2119,1,2,1.4474937289114918,1
2118,2121,2119,2118,2118,2116,2117,2118,2117,2118,2117,2120,2121,2119,2116,-2,-2,1.5675276256394517,1
2121,2119,2118,2118,2116,2117,2118,2117,2118,2117,2120,2121,2119,2116,2117,-4,0,1.5976172734359604,0
2119,2118,2118,2116,2117,2118,2117,2118,2117,2120,2121,2119,2116,2117,2114,-5,-4,1.7182493859684491,0
2118,2118,2116,2117,2118,2117,2118,2117,2120,2121,2119,2116,2117,2114,2115,-3,-2,1.804755622554715,0
2118,2116,2117,2118,2117,2118,2117,2120,2121,2119,2116,2117,2114,2115,2116,-2,-4,1.8309508328682538,0
2116,2117,2118,2117,2118,2117,2120,2121,2119,2116,2117,2114,2115,2116,2116,0,-5,1.8464895909600492,0
2117,2118,2117,2118,2117,2120,2121,2119,2116,2117,2114,2115,2116,2116,2118,1,-1,1.8309508328682538,0
2118,2117,2118,2117,2120,2121,2119,2116,2117,2114,2115,2116,2116,2118,2341,223,225,57.791744343683845,0
2117,2118,2117,2120,2121,2119,2116,2117,2114,2115,2116,2116,2118,2341,2340,223,223,78.58207720048419,0
2118,2117,2120,2121,2119,2116,2117,2114,2115,2116,2116,2118,2341,2340,2350,232,236,93.78612954610131,0
2117,2120,2121,2119,2116,2117,2114,2115,2116,2116,2118,2341,2340,2350,2340,223,225,103.29131250059338,0
2120,2121,2119,2116,2117,2114,2115,2116,2116,2118,2341,2340,2350,2340,2344,224,228,110.2172313898244,0
2121,2119,2116,2117,2114,2115,2116,2116,2118,2341,2340,2350,2340,2344,2345,224,229,114.86318984318858,0
2119,2116,2117,2114,2115,2116,2116,2118,2341,2340,2350,2340,2344,2345,2328,209,210,116.1602751538129,0
2116,2117,2114,2115,2116,2116,2118,2341,2340,2350,2340,2344,2345,2328,2348,232,7,116.806229449012,0
2117,2114,2115,2116,2116,2118,2341,2340,2350,2340,2344,2345,2328,2348,2332,215,-8,114.1699651939202,0
2114,2115,2116,2116,2118,2341,2340,2350,2340,2344,2345,2328,2348,2332,2320,206,-30,109.0778664641959,0
2115,2116,2116,2118,2341,2340,2350,2340,2344,2345,2328,2348,2332,2320,2332,217,-8,101.88368718438548,0
2116,2116,2118,2341,2340,2350,2340,2344,2345,2328,2348,2332,2320,2332,2317,201,-27,91.47666889639649,0
2116,2118,2341,2340,2350,2340,2344,2345,2328,2348,2332,2320,2332,2317,2346,230,1,78.07981264614524,0
2118,2341,2340,2350,2340,2344,2345,2328,2348,2332,2320,2332,2317,2346,2335,217,7,57.38690741673699,0
2341,2340,2350,2340,2344,2345,2328,2348,2332,2320,2332,2317,2346,2335,2338,-3,-10,9.794070120425395,0
2340,2350,2340,2344,2345,2328,2348,2332,2320,2332,2317,2346,2335,2338,2331,-9,-1,9.847407200447668,0
2350,2340,2344,2345,2328,2348,2332,2320,2332,2317,2346,2335,2338,2331,2350,0,30,10.42981075480051,0
2340,2344,2345,2328,2348,2332,2320,2332,2317,2346,2335,2338,2331,2350,2314,-26,-18,11.343133018115703,0
2344,2345,2328,2348,2332,2320,2332,2317,2346,2335,2338,2331,2350,2314,2322,-22,5,11.685562928347995,0
2345,2328,2348,2332,2320,2332,2317,2346,2335,2338,2331,2350,2314,2322,2315,-30,-31,12.205775369920273,0
2328,2348,2332,2320,2332,2317,2346,2335,2338,2331,2350,2314,2322,2315,2347,19,12,12.37316604977231,0
2348,2332,2320,2332,2317,2346,2335,2338,2331,2350,2314,2322,2315,2347,2326,-22,-12,12.42616287554303,0
2332,2320,2332,2317,2346,2335,2338,2331,2350,2314,2322,2315,2347,2326,2312,-20,-19,12.494951361402313,0
2320,2332,2317,2346,2335,2338,2331,2350,2314,2322,2315,2347,2326,2312,2342,22,-8,12.918425379500176,0
2332,2317,2346,2335,2338,2331,2350,2314,2322,2315,2347,2326,2312,2342,2323,-9,9,12.778329870750492,0
2317,2346,2335,2338,2331,2350,2314,2322,2315,2347,2326,2312,2342,2323,2326,9,4,12.805132899405168,0
2346,2335,2338,2331,2350,2314,2322,2315,2347,2326,2312,2342,2323,2326,2323,-23,8,12.472827609304499,0
2335,2338,2331,2350,2314,2322,2315,2347,2326,2312,2342,2323,2326,2323,2336,1,-11,11.805971047777154,0
2338,2331,2350,2314,2322,2315,2347,2326,2312,2342,2323,2326,2323,2336,2341,3,15,12.109421754902058,0
2331,2350,2314,2322,2315,2347,2326,2312,2342,2323,2326,2323,2336,2341,2331,0,19,11.901180413643651,0
2350,2314,2322,2315,2347,2326,2312,2342,2323,2326,2323,2336,2341,2331,2342,-8,0,12.346196638178553,0
2314,2322,2315,2347,2326,2312,2342,2323,2326,2323,2336,2341,2331,2342,2321,7,-2,11.208840048733645,0
2322,2315,2347,2326,2312,2342,2323,2326,2323,2336,2341,2331,2342,2321,2328,6,2,10.515294982615968,0
2315,2347,2326,2312,2342,2323,2326,2323,2336,2341,2331,2342,2321,2328,2347,32,24,11.279986491042232,0
2347,2326,2312,2342,2323,2326,2323,2336,2341,2331,2342,2321,2328,2347,2345,-2,9,10.95879729236918,0
2326,2312,2342,2323,2326,2323,2336,2341,2331,2342,2321,2328,2347,2345,2337,11,-4,10.309496315810694,0
2312,2342,2323,2326,2323,2336,2341,2331,2342,2321,2328,2347,2345,2337,2319,7,-12,10.749529336318915,0
2342,2323,2326,2323,2336,2341,2331,2342,2321,2328,2347,2345,2337,2319,2326,-16,-16,9.463211978624432,0
2323,2326,2323,2336,2341,2331,2342,2321,2328,2347,2345,2337,2319,2326,2327,4,6,9.171903266160712,0
2326,2323,2336,2341,2331,2342,2321,2328,2347,2345,2337,2319,2326,2327,2328,2,0,8.929885617568523,0
2323,2336,2341,2331,2342,2321,2328,2347,2345,2337,2319,2326,2327,2328,2353,30,6,10.2942424962417,0
2336,2341,2331,2342,2321,2328,2347,2345,2337,2319,2326,2327,2328,2353,2340,4,-5,9.974729976056398,0
2341,2331,2342,2321,2328,2347,2345,2337,2319,2326,2327,2328,2353,2340,2331,-10,-6,10.012848888160795,0
2331,2342,2321,2328,2347,2345,2337,2319,2326,2327,2328,2353,2340,2331,2326,-5,7,10.055559940365614,0
2342,2321,2328,2347,2345,2337,2319,2326,2327,2328,2353,2340,2331,2326,2329,-13,3,10.102804891052122,0
2321,2328,2347,2345,2337,2319,2326,2327,2328,2353,2340,2331,2326,2329,2337,16,10,9.873967697700762,0
2328,2347,2345,2337,2319,2326,2327,2328,2353,2340,2331,2326,2329,2337,2343,15,15,9.605058191241886,0
2347,2345,2337,2319,2326,2327,2328,2353,2340,2331,2326,2329,2337,2343,2334,-13,-19,9.443062457244926,0
2345,2337,2319,2326,2327,2328,2353,2340,2331,2326,2329,2337,2343,2334,2338,-7,-2,8.88176301675035,0
2337,2319,2326,2327,2328,2353,2340,2331,2326,2329,2337,2343,2334,2338,2331,-6,0,8.387632619063675,0
2319,2326,2327,2328,2353,2340,2331,2326,2329,2337,2343,2334,2338,2331,2323,4,-3,8.715066319448232,0
2326,2327,2328,2353,2340,2331,2326,2329,2337,2343,2334,2338,2331,2323,2343,17,14,8.284811116621503,0
2327,2328,2353,2340,2331,2326,2329,2337,2343,2334,2338,2331,2323,2343,2341,14,4,8.16321598624557,0
2328,2353,2340,2331,2326,2329,2337,2343,2334,2338,2331,2323,2343,2341,2338,10,-5,7.889112449325034,0
2353,2340,2331,2326,2329,2337,2343,2334,2338,2331,2323,2343,2341,2338,2333,-20,-1,7.643858412383855,0
2340,2331,2326,2329,2337,2343,2334,2338,2331,2323,2343,2341,2338,2333,2327,-13,-11,6.352352395166766,0
2331,2326,2329,2337,2343,2334,2338,2331,2323,2343,2341,2338,2333,2327,2347,16,16,7.025124977705447,0
2326,2329,2337,2343,2334,2338,2331,2323,2343,2341,2338,2333,2327,2347,2344,18,21,7.3270535882927925,0
2329,2337,2343,2334,2338,2331,2323,2343,2341,2338,2333,2327,2347,2344,2341,12,-2,6.936446187658758,0
2337,2343,2334,2338,2331,2323,2343,2341,2338,2333,2327,2347,2344,2341,2325,-12,-16,7.315996823660432,0
2343,2334,2338,2331,2323,2343,2341,2338,2333,2327,2347,2344,2341,2325,2330,-13,-8,7.491582578054488,0
2334,2338,2331,2323,2343,2341,2338,2333,2327,2347,2344,2341,2325,2330,2328,-6,-5,7.4724892263619385,0
2338,2331,2323,2343,2341,2338,2333,2327,2347,2344,2341,2325,2330,2328,2328,-10,1,7.6799057533899715,0
2331,2323,2343,2341,2338,2333,2327,2347,2344,2341,2325,2330,2328,2328,2326,-5,-21,7.907199853539148,0
2323,2343,2341,2338,2333,2327,2347,2344,2341,2325,2330,2328,2328,2326,2334,11,-10,7.872798256081022,0
2343,2341,2338,2333,2327,2347,2344,2341,2325,2330,2328,2328,2326,2334,2313,-30,-28,9.174498818542,0
2341,2338,2333,2327,2347,2344,2341,2325,2330,2328,2328,2326,2334,2313,2318,-23,-7,9.530902120895757,0
2338,2333,2327,2347,2344,2341,2325,2330,2328,2328,2326,2334,2313,2318,2340,2,10,9.463211978624432,0
2333,2327,2347,2344,2341,2325,2330,2328,2328,2326,2334,2313,2318,2340,2346,13,18,10.064080399406311,0
2327,2347,2344,2341,2325,2330,2328,2328,2326,2334,2313,2318,2340,2346,2336,9,8,10.115052432601905,0
2347,2344,2341,2325,2330,2328,2328,2326,2334,2313,2318,2340,2346,2336,2339,-8,13,10.14889156509222,0
2344,2341,2325,2330,2328,2328,2326,2334,2313,2318,2340,2346,2336,2339,2342,-2,8,9.72967967955095,0
2341,2325,2330,2328,2328,2326,2334,2313,2318,2340,2346,2336,2339,2342,2310,-31,-3,10.802116194788606,0
2325,2330,2328,2328,2326,2334,2313,2318,2340,2346,2336,2339,2342,2310,2337,12,19,10.568596789320619,0
2330,2328,2328,2326,2334,2313,2318,2340,2346,2336,2339,2342,2310,2337,2335,5,-5,10.537009605603073,0
2328,2328,2326,2334,2313,2318,2340,2346,2336,2339,2342,2310,2337,2335,2336,8,-10,10.61804394146385,0
2328,2326,2334,2313,2318,2340,2346,2336,2339,2342,2310,2337,2335,2336,2340,12,4,10.810048235652923,0
2326,2334,2313,2318,2340,2346,2336,2339,2342,2310,2337,2335,2336,2340,2334,8,-5,10.76236830017313,0
2334,2313,2318,2340,2346,2336,2339,2342,2310,2337,2335,2336,2340,2334,2326,-8,-16,10.76236830017313,0
2313,2318,2340,2346,2336,2339,2342,2310,2337,2335,2336,2340,2334,2326,2329,16,19,10.78667608452117,0
2318,2340,2346,2336,2339,2342,2310,2337,2335,2336,2340,2334,2326,2329,2348,30,11,10.133395989781228,0
2340,2346,2336,2339,2342,2310,2337,2335,2336,2340,2334,2326,2329,2348,2341,1,6,9.168787633415155,0
2346,2336,2339,2342,2310,2337,2335,2336,2340,2334,2326,2329,2348,2341,2347,1,11,9.560334722173696,0
2336,2339,2342,2310,2337,2335,2336,2340,2334,2326,2329,2348,2341,2347,2352,16,12,10.10091933581154,0
2339,2342,2310,2337,2335,2336,2340,2334,2326,2329,2348,2341,2347,2352,2335,-4,1,10.10987259116176,0
2342,2310,2337,2335,2336,2340,2334,2326,2329,2348,2341,2347,2352,2335,2309,-33,-17,12.348896229835203,0
2310,2337,2335,2336,2340,2334,2326,2329,2348,2341,2347,2352,2335,2309,2284,-26,-45,17.791918978917955,0
2337,2335,2336,2340,2334,2326,2329,2348,2341,2347,2352,2335,2309,2284,2268,-69,-80,23.650631724171365,0
2335,2336,2340,2334,2326,2329,2348,2341,2347,2352,2335,2309,2284,2268,2275,-60,-66,27.138445756808515,0
2336,2340,2334,2326,2329,2348,2341,2347,2352,2335,2309,2284,2268,2275,2293,-43,-54,28.06590882361086,0
2340,2334,2326,2329,2348,2341,2347,2352,2335,2309,2284,2268,2275,2293,2345,5,-7,28.499289882548368,0
2334,2326,2329,2348,2341,2347,2352,2335,2309,2284,2268,2275,2293,2345,2321,-13,-14,28.048087957920377,0
2326,2329,2348,2341,2347,2352,2335,2309,2284,2268,2275,2293,2345,2321,2363,37,54,29.980469833352704,0
2329,2348,2341,2347,2352,2335,2309,2284,2268,2275,2293,2345,2321,2363,2351,22,67,30.87640492272993,0
2348,2341,2347,2352,2335,2309,2284,2268,2275,2293,2345,2321,2363,2351,2378,30,110,33.881445969031205,0
2341,2347,2352,2335,2309,2284,2268,2275,2293,2345,2321,2363,2351,2378,2378,37,103,36.007274397318795,0
2347,2352,2335,2309,2284,2268,2275,2293,2345,2321,2363,2351,2378,2378,2344,-3,51,36.08495267454025,0
2352,2335,2309,2284,2268,2275,2293,2345,2321,2363,2351,2378,2378,2344,2372,20,27,37.49895236631856,0
2335,2309,2284,2268,2275,2293,2345,2321,2363,2351,2378,2378,2344,2372,2345,10,24,37.264434723179356,0
2309,2284,2268,2275,2293,2345,2321,2363,2351,2378,2378,2344,2372,2345,2369,60,6,38.55422896944732,0
2284,2268,2275,2293,2345,2321,2363,2351,2378,2378,2344,2372,2345,2369,2346,62,-5,38.08986866921564,0
2268,2275,2293,2345,2321,2363,2351,2378,2378,2344,2372,2345,2369,2346,2373,105,-5,36.39426956462868,0
2275,2293,2345,2321,2363,2351,2378,2378,2344,2372,2345,2369,2346,2373,2357,82,-21,30.321295361197095,0
2293,2345,2321,2363,2351,2378,2378,2344,2372,2345,2369,2346,2373,2357,2357,64,13,22.810398631200766,0
2345,2321,2363,2351,2378,2378,2344,2372,2345,2369,2346,2373,2357,2357,2334,-11,-38,16.796541594144003,0
2321,2363,2351,2378,2378,2344,2372,2345,2369,2346,2373,2357,2357,2334,2323,2,-22,18.641224157636163,0
2363,2351,2378,2378,2344,2372,2345,2369,2346,2373,2357,2357,2334,2323,2317,-46,-52,19.169171678952193,0
2351,2378,2378,2344,2372,2345,2369,2346,2373,2357,2357,2334,2323,2317,2299,-52,-47,23.58833448570551,0
2378,2378,2344,2372,2345,2369,2346,2373,2357,2357,2334,2323,2317,2299,2316,-62,-57,25.114594504846323,0
2378,2344,2372,2345,2369,2346,2373,2357,2357,2334,2323,2317,2299,2316,2310,-68,-47,25.294456384937863,0
2344,2372,2345,2369,2346,2373,2357,2357,2334,2323,2317,2299,2316,2310,2325,-19,-32,23.654859563150676,0
2372,2345,2369,2346,2373,2357,2357,2334,2323,2317,2299,2316,2310,2325,2335,-37,1,23.636734928818704,0
2345,2369,2346,2373,2357,2357,2334,2323,2317,2299,2316,2310,2325,2335,2308,-37,-15,22.92991392005108,0
2369,2346,2373,2357,2357,2334,2323,2317,2299,2316,2310,2325,2335,2308,2325,-44,8,22.842525087672605,0
2346,2373,2357,2357,2334,2323,2317,2299,2316,2310,2325,2335,2308,2325,2340,-6,41,20.698516164898667,0
2373,2357,2357,2334,2323,2317,2299,2316,2310,2325,2335,2308,2325,2340,2342,-31,26,20.516427796373556,0
2357,2357,2334,2323,2317,2299,2316,2310,2325,2335,2308,2325,2340,2342,2349,-8,39,17.731596764237672,0
2357,2334,2323,2317,2299,2316,2310,2325,2335,2308,2325,2340,2342,2349,2347,-10,22,16.7710067278821,0
2334,2323,2317,2299,2316,2310,2325,2335,2308,2325,2340,2342,2349,2347,2351,17,16,16.099985211469104,0
2323,2317,2299,2316,2310,2325,2335,2308,2325,2340,2342,2349,2347,2351,2351,28,43,17.113904121670025,0
2317,2299,2316,2310,2325,2335,2308,2325,2340,2342,2349,2347,2351,2351,2346,29,21,17.543686966568696,0
2299,2316,2310,2325,2335,2308,2325,2340,2342,2349,2347,2351,2351,2346,2359,60,19,18.51974493293448,0
2316,2310,2325,2335,2308,2325,2340,2342,2349,2347,2351,2351,2346,2359,2348,32,6,16.16521839364646,0
2310,2325,2335,2308,2325,2340,2342,2349,2347,2351,2351,2346,2359,2348,2341,31,-8,15.122672981164344,0
2325,2335,2308,2325,2340,2342,2349,2347,2351,2351,2346,2359,2348,2341,2354,29,7,13.372680039115997,0
2335,2308,2325,2340,2342,2349,2347,2351,2351,2346,2359,2348,2341,2354,2330,-5,-21,12.991572359839758,2
2308,2325,2340,2342,2349,2347,2351,2351,2346,2359,2348,2341,2354,2330,2111,-197,-240,61.06811185646962,2
2325,2340,2342,2349,2347,2351,2351,2346,2359,2348,2341,2354,2330,2111,2116,-209,-230,81.86923371188611,2
2340,2342,2349,2347,2351,2351,2346,2359,2348,2341,2354,2330,2111,2116,2120,-220,-239,95.82324998712598,2
2342,2349,2347,2351,2351,2346,2359,2348,2341,2354,2330,2111,2116,2120,2124,-218,-224,105.20691630351703,2
2349,2347,2351,2351,2346,2359,2348,2341,2354,2330,2111,2116,2120,2124,2129,-220,-212,111.29719972518028,2
2347,2351,2351,2346,2359,2348,2341,2354,2330,2111,2116,2120,2124,2129,2130,-217,-224,114.74808847873594,2
2351,2351,2346,2359,2348,2341,2354,2330,2111,2116,2120,2124,2129,2130,2133,-218,-197,116.07255530588655,2
2351,2346,2359,2348,2341,2354,2330,2111,2116,2120,2124,2129,2130,2133,2131,-220,20,115.330085283193,2
2346,2359,2348,2341,2354,2330,2111,2116,2120,2124,2129,2130,2133,2131,2132,-214,16,112.5013015797722,2
2359,2348,2341,2354,2330,2111,2116,2120,2124,2129,2130,2133,2131,2132,2130,-229,10,108.08078988819958,2
2348,2341,2354,2330,2111,2116,2120,2124,2129,2130,2133,2131,2132,2130,2128,-220,4,99.82713630500048,2
2341,2354,2330,2111,2116,2120,2124,2129,2130,2133,2131,2132,2130,2128,2127,-214,-2,89.65207882751653,2
2354,2330,2111,2116,2120,2124,2129,2130,2133,2131,2132,2130,2128,2127,2127,-227,-3,76.38268315341041,2
2330,2111,2116,2120,2124,2129,2130,2133,2131,2132,2130,2128,2127,2127,2131,-199,-2,52.949391830672575,2
2111,2116,2120,2124,2129,2130,2133,2131,2132,2130,2128,2127,2127,2131,2135,24,4,6.627504019146992,0
2116,2120,2124,2129,2130,2133,2131,2132,2130,2128,2127,2127,2131,2135,2137,21,5,5.459809869356607,0
2120,2124,2129,2130,2133,2131,2132,2130,2128,2127,2127,2131,2135,2137,2135,15,5,4.415341220702891,0
2124,2129,2130,2133,2131,2132,2130,2128,2127,2127,2131,2135,2137,2135,2137,13,9,3.825976377095818,0
2129,2130,2133,2131,2132,2130,2128,2127,2127,2131,2135,2137,2135,2137,2136,7,9,3.4819261226811697,0
2130,2133,2131,2132,2130,2128,2127,2127,2131,2135,2137,2135,2137,2136,2132,2,5,3.390462814312833,0
2133,2131,2132,2130,2128,2127,2127,2131,2135,2137,2135,2137,2136,2132,2129,-4,-2,3.4434202266268428,0
2131,2132,2130,2128,2127,2127,2131,2135,2137,2135,2137,2136,2132,2129,2130,-1,-5,3.468223093829379,0
2132,2130,2128,2127,2127,2131,2135,2137,2135,2137,2136,2132,2129,2130,2130,-2,-7,3.494212902718409,0
2130,2128,2127,2127,2131,2135,2137,2135,2137,2136,2132,2129,2130,2130,2131,1,-4,3.498298906339371,0
2128,2127,2127,2131,2135,2137,2135,2137,2136,2132,2129,2130,2130,2131,2134,6,-3,3.5145954180219596,0
2127,2127,2131,2135,2137,2135,2137,2136,2132,2129,2130,2130,2131,2134,2135,8,-1,3.418437404094784,0
2127,2131,2135,2137,2135,2137,2136,2132,2129,2130,2130,2131,2134,2135,2140,13,8,3.594970031002974,0
2131,2135,2137,2135,2137,2136,2132,2129,2130,2130,2131,2134,2135,2140,2138,7,9,3.3380918415851206,0
2135,2137,2135,2137,2136,2132,2129,2130,2130,2131,2134,2135,2140,2138,2137,2,7,3.3123146848433,0
2137,2135,2137,2136,2132,2129,2130,2130,2131,2134,2135,2140,2138,2137,2134,-3,4,3.3094381626464866,0
2135,2137,2136,2132,2129,2130,2130,2131,2134,2135,2140,2138,2137,2134,2132,-3,1,3.2732683535398857,0
2137,2136,2132,2129,2130,2130,2131,2134,2135,2140,2138,2137,2134,2132,2132,-5,-2,3.299350585450762,0
2136,2132,2129,2130,2130,2131,2134,2135,2140,2138,2137,2134,2132,2132,2133,-3,-2,3.1817934445544265,0
2132,2129,2130,2130,2131,2134,2135,2140,2138,2137,2134,2132,2132,2133,2133,1,-7,3.1091263510296048,0
2129,2130,2130,2131,2134,2135,2140,2138,2137,2134,2132,2132,2133,2133,2135,6,-3,3.113717728895491,0
2130,2130,2131,2134,2135,2140,2138,2137,2134,2132,2132,2133,2133,2135,2138,8,1,3.0441200151548995,0
2130,2131,2134,2135,2140,2138,2137,2134,2132,2132,2133,2133,2135,2138,2139,9,5,3.0581662728473336,0
2131,2134,2135,2140,2138,2137,2134,2132,2132,2133,2133,2135,2138,2139,2140,9,8,3.0425553170226594,0
2134,2135,2140,2138,2137,2134,2132,2132,2133,2133,2135,2138,2139,2140,2137,3,5,2.808151400069855,0
2135,2140,2138,2137,2134,2132,2132,2133,2133,2135,2138,2139,2140,2137,2136,1,3,2.76371041140262,0
2140,2138,2137,2134,2132,2132,2133,2133,2135,2138,2139,2140,2137,2136,2134,-6,1,2.799659843283687,0
2138,2137,2134,2132,2132,2133,2133,2135,2138,2139,2140,2137,2136,2134,2133,-5,-2,2.6403462976338106,0
2137,2134,2132,2132,2133,2133,2135,2138,2139,2140,2137,2136,2134,2133,2134,-3,-4,2.5597618936887376,0
2134,2132,2132,2133,2133,2135,2138,2139,2140,2137,2136,2134,2133,2134,2133,-1,-6,2.5597618936887376,0
2132,2132,2133,2133,2135,2138,2139,2140,2137,2136,2134,2133,2134,2133,2139,7,-1,2.7568097504180447,0
2132,2133,2133,2135,2138,2139,2140,2137,2136,2134,2133,2134,2133,2139,2138,6,1,2.6939084723024385,0
2133,2133,2135,2138,2139,2140,2137,2136,2134,2133,2134,2133,2139,2138,2140,7,4,2.722044049886741,0
2133,2135,2138,2139,2140,2137,2136,2134,2133,2134,2133,2139,2138,2140,2140,7,6,2.7464262493023806,0
2135,2138,2139,2140,2137,2136,2134,2133,2134,2133,2139,2138,2140,2140,2138,3,5,2.5764501233470907,0
2138,2139,2140,2137,2136,2134,2133,2134,2133,2139,2138,2140,2140,2138,2137,-1,3,2.520393015460278,0
2139,2140,2137,2136,2134,2133,2134,2133,2139,2138,2140,2140,2138,2137,2134,-5,1,2.6240644591385873,0
2140,2137,2136,2134,2133,2134,2133,2139,2138,2140,2140,2138,2137,2134,2132,-8,-7,2.819996622760558,0
2137,2136,2134,2133,2134,2133,2139,2138,2140,2140,2138,2137,2134,2132,2133,-4,-5,2.7481595573002946,0
2136,2134,2133,2134,2133,2139,2138,2140,2140,2138,2137,2134,2132,2133,2134,-2,-6,2.7688746209726918,0
2134,2133,2134,2133,2139,2138,2140,2140,2138,2137,2134,2132,2133,2134,2137,3,-3,2.7894358535288784,0
2133,2134,2133,2139,2138,2140,2140,2138,2137,2134,2132,2133,2134,2137,2141,8,3,3.051931472737505,0
2134,2133,2139,2138,2140,2140,2138,2137,2134,2132,2133,2134,2137,2141,2143,9,6,3.3777986632604096,0
2133,2139,2138,2140,2140,2138,2137,2134,2132,2133,2134,2137,2141,2143,2142,9,8,3.521363372331802,0
2139,2138,2140,2140,2138,2137,2134,2132,2133,2134,2137,2141,2143,2142,2139,0,7,3.320929301953209,0
2138,2140,2140,2138,2137,2134,2132,2133,2134,2137,2141,2143,2142,2139,2138,0,5,3.305118685283408,0
2140,2140,2138,2137,2134,2132,2133,2134,2137,2141,2143,2142,2139,2138,2133,-7,-1,3.521363372331802,0
2140,2138,2137,2134,2132,2133,2134,2137,2141,2143,2142,2139,2138,2133,2135,-5,-2,3.494212902718409,0
2138,2137,2134,2132,2133,2134,2137,2141,2143,2142,2139,2138,2133,2135,2135,-3,-6,3.4323391995769272,0
2137,2134,2132,2133,2134,2137,2141,2143,2142,2139,2138,2133,2135,2135,2137,0,-6,3.4156502553198664,0
2134,2132,2133,2134,2137,2141,2143,2142,2139,2138,2133,2135,2135,2137,2137,3,-5,3.4156502553198664,0
2132,2133,2134,2137,2141,2143,2142,2139,2138,2133,2135,2135,2137,2137,2142,10,3,3.589667712437223,0
2133,2134,2137,2141,2143,2142,2139,2138,2133,2135,2135,2137,2137,2142,2143,10,5,3.575045787252575,0
2134,2137,2141,2143,2142,2139,2138,2133,2135,2135,2137,2137,2142,2143,2143,9,10,3.521363372331802,0
2137,2141,2143,2142,2139,2138,2133,2135,2135,2137,2137,2142,2143,2143,2141,4,6,3.32665998663324,0
2141,2143,2142,2139,2138,2133,2135,2135,2137,2137,2142,2143,2143,2141,2140,-1,5,3.2834360631741224,0
2143,2142,2139,2138,2133,2135,2135,2137,2137,2142,2143,2143,2141,2140,2140,-3,3,3.255764119219941,0
2142,2139,2138,2133,2135,2135,2137,2137,2142,2143,2143,2141,2140,2140,2133,-9,-4,3.4406533155921477,0
2139,2138,2133,2135,2135,2137,2137,2142,2143,2143,2141,2140,2140,2133,2100,-39,-42,10.422960003669553,0
2138,2133,2135,2135,2137,2137,2142,2143,2143,2141,2140,2140,2133,2100,2100,-38,-43,13.850562993542727,0
2133,2135,2135,2137,2137,2142,2143,2143,2141,2140,2140,2133,2100,2100,2106,-27,-37,15.422617898954213,0
2135,2135,2137,2137,2142,2143,2143,2141,2140,2140,2133,2100,2100,2106,2109,-26,-32,16.413409152275463,0
2135,2137,2137,2142,2143,2143,2141,2140,2140,2133,2100,2100,2106,2109,2114,-21,-26,16.792855623746664,0
2137,2137,2142,2143,2143,2141,2140,2140,2133,2100,2100,2106,2109,2114,2115,-22,-25,16.990193249832878,0
2137,2142,2143,2143,2141,2140,2140,2133,2100,2100,2106,2109,2114,2115,2113,-24,-20,17.077414770336148,0
2142,2143,2143,2141,2140,2140,2133,2100,2100,2106,2109,2114,2115,2113,2108,-34,8,17.270398567105122,0
2143,2143,2141,2140,2140,2133,2100,2100,2106,2109,2114,2115,2113,2108,2107,-36,7,16.899704139422084,0
2143,2141,2140,2140,2133,2100,2100,2106,2109,2114,2115,2113,2108,2107,2108,-35,2,16.00833116432399,0
2141,2140,2140,2133,2100,2100,2106,2109,2114,2115,2113,2108,2107,2108,2141,0,32,15.796322658258457,0
2140,2140,2133,2100,2100,2106,2109,2114,2115,2113,2108,2107,2108,2141,2145,5,31,16.23400311515484,0
2140,2133,2100,2100,2106,2109,2114,2115,2113,2108,2107,2108,2141,2145,2149,9,34,17.217930852955092,0
2133,2100,2100,2106,2109,2114,2115,2113,2108,2107,2108,2141,2145,2149,2150,17,37,18.243850888397855,0
2100,2100,2106,2109,2114,2115,2113,2108,2107,2108,2141,2145,2149,2150,2150,50,42,19.595917942265423,0
2100,2106,2109,2114,2115,2113,2108,2107,2108,2141,2145,2149,2150,2150,2153,53,46,20.304350929460085,0
2106,2109,2114,2115,2113,2108,2107,2108,2141,2145,2149,2150,2150,2153,2149,43,41,20.014994379214798,0
2109,2114,2115,2113,2108,2107,2108,2141,2145,2149,2150,2150,2153,2149,2149,40,8,19.74721197922332,0
2114,2115,2113,2108,2107,2108,2141,2145,2149,2150,2150,2153,2149,2149,2148,34,3,19.251963412548218,0
2115,2113,2108,2107,2108,2141,2145,2149,2150,2150,2153,2149,2149,2148,2148,33,-1,18.818177635568475,0
2113,2108,2107,2108,2141,2145,2149,2150,2150,2153,2149,2149,2148,2148,2148,35,-2,18.163804929689416,0
2108,2107,2108,2141,2145,2149,2150,2150,2153,2149,2149,2148,2148,2148,2149,41,-1,17.00364106666009,0
2107,2108,2141,2145,2149,2150,2150,2153,2149,2149,2148,2148,2148,2149,2152,45,-1,14.70406487368455,0
2108,2141,2145,2149,2150,2150,2153,2149,2149,2148,2148,2148,2149,2152,2151,43,2,10.889050857234002,0
2141,2145,2149,2150,2150,2153,2149,2149,2148,2148,2148,2149,2152,2151,2149,8,0,2.840187787218772,0
2145,2149,2150,2150,2153,2149,2149,2148,2148,2148,2149,2152,2151,2149,2154,9,6,2.2296700588716196,0
2149,2150,2150,2153,2149,2149,2148,2148,2148,2149,2152,2151,2149,2154,2148,-1,0,1.8973665961010275,0
2150,2150,2153,2149,2149,2148,2148,2148,2149,2152,2151,2149,2154,2148,2139,-11,-9,3.3777986632604096,0
2150,2153,2149,2149,2148,2148,2148,2149,2152,2151,2149,2154,2148,2139,2146,-4,-3,3.461351236287988,0
2153,2149,2149,2148,2148,2148,2149,2152,2151,2149,2154,2148,2139,2146,2147,-6,-5,3.4778208831448025,0
2149,2149,2148,2148,2148,2149,2152,2151,2149,2154,2148,2139,2146,2147,2148,-1,-3,3.265986323710904,0
2149,2148,2148,2148,2149,2152,2151,2149,2154,2148,2139,2146,2147,2148,2146,-3,-3,3.313752009573496,0
2148,2148,2148,2149,2152,2151,2149,2154,2148,2139,2146,2147,2148,2146,2148,0,-6,3.305118685283408,0
2148,2148,2149,2152,2151,2149,2154,2148,2139,2146,2147,2148,2146,2148,2156,8,8,3.8877095717511763,0
2148,2149,2152,2151,2149,2154,2148,2139,2146,2147,2148,2146,2148,2156,2155,7,16,4.216746658379227,0
2149,2152,2151,2149,2154,2148,2139,2146,2147,2148,2146,2148,2156,2155,2156,7,10,4.563832975533989,0
2152,2151,2149,2154,2148,2139,2146,2147,2148,2146,2148,2156,2155,2156,2142,-10,-5,4.96943035923013,0
2151,2149,2154,2148,2139,2146,2147,2148,2146,2148,2156,2155,2156,2142,2126,-25,-22,7.688581515096638,0
2149,2154,2148,2139,2146,2147,2148,2146,2148,2156,2155,2156,2142,2126,2140,-9,-6,7.8437114635744685,0
2154,2148,2139,2146,2147,2148,2146,2148,2156,2155,2156,2142,2126,2140,2138,-16,-10,8.119347850893538,0
2148,2139,2146,2147,2148,2146,2148,2156,2155,2156,2142,2126,2140,2138,2132,-16,-24,8.534523726494363,0
2139,2146,2147,2148,2146,2148,2156,2155,2156,2142,2126,2140,2138,2132,2138,-1,-17,8.628855246041786,0
2146,2147,2148,2146,2148,2156,2155,2156,2142,2126,2140,2138,2132,2138,2064,-82,-92,22.380476185410227,0
2147,2148,2146,2148,2156,2155,2156,2142,2126,2140,2138,2132,2138,2064,2120,-27,-22,22.786169573000283,0
2148,2146,2148,2156,2155,2156,2142,2126,2140,2138,2132,2138,2064,2120,2090,-58,-36,25.591479236726617,0
2146,2148,2156,2155,2156,2142,2126,2140,2138,2132,2138,2064,2120,2090,2114,-32,-26,25.69880486381753,0
2148,2156,2155,2156,2142,2126,2140,2138,2132,2138,2064,2120,2090,2114,2119,-29,-19,25.51806083093754,0
2156,2155,2156,2142,2126,2140,2138,2132,2138,2064,2120,2090,2114,2119,2125,-31,-7,24.99333244420733,0
2155,2156,2142,2126,2140,2138,2132,2138,2064,2120,2090,2114,2119,2125,2127,-28,-11,23.735045417112243,0
2156,2142,2126,2140,2138,2132,2138,2064,2120,2090,2114,2119,2125,2127,2121,-35,57,22.321887614327483,0
2142,2126,2140,2138,2132,2138,2064,2120,2090,2114,2119,2125,2127,2121,2125,-17,5,20.451335967538718,0
2126,2140,2138,2132,2138,2064,2120,2090,2114,2119,2125,2127,2121,2125,2065,-61,-25,24.226510469397144,0
2140,2138,2132,2138,2064,2120,2090,2114,2119,2125,2127,2121,2125,2065,2077,-63,-37,26.054887120406853,0
2138,2132,2138,2064,2120,2090,2114,2119,2125,2127,2121,2125,2065,2077,2079,-59,-40,26.299013198941424,0
2132,2138,2064,2120,2090,2114,2119,2125,2127,2121,2125,2065,2077,2079,2061,-71,-64,27.697859638813764,0
2138,2064,2120,2090,2114,2119,2125,2127,2121,2125,2065,2077,2079,2061,2053,-85,-74,29.41055851868428,0
2064,2120,2090,2114,2119,2125,2127,2121,2125,2065,2077,2079,2061,2053,2051,-13,-70,29.64905844485903,0
2120,2090,2114,2119,2125,2127,2121,2125,2065,2077,2079,2061,2053,2051,2048,-72,-77,31.01305408710216,0
2090,2114,2119,2125,2127,2121,2125,2065,2077,2079,2061,2053,2051,2048,2043,-47,-22,32.332793319005454,0
2114,2119,2125,2127,2121,2125,2065,2077,2079,2061,2053,2051,2048,2043,2043,-71,-34,34.1964910480593,0
2119,2125,2127,2121,2125,2065,2077,2079,2061,2053,2051,2048,2043,2043,2051,-68,-28,34.038213819176825,0
2125,2127,2121,2125,2065,2077,2079,2061,2053,2051,2048,2043,2043,2051,2055,-70,-6,32.67691773073085,0
2127,2121,2125,2065,2077,2079,2061,2053,2051,2048,2043,2043,2051,2055,2063,-64,10,29.674905223100545,0
2121,2125,2065,2077,2079,2061,2053,2051,2048,2043,2043,2051,2055,2063,2069,-52,18,25.28259329676297,0
2125,2065,2077,2079,2061,2053,2051,2048,2043,2043,2051,2055,2063,2069,2069,-56,21,20.44108840639596,0
2065,2077,2079,2061,2053,2051,2048,2043,2043,2051,2055,2063,2069,2069,2070,5,27,11.663128715253528,0
2077,2079,2061,2053,2051,2048,2043,2043,2051,2055,2063,2069,2069,2070,2067,-10,24,11.738013136001866,0
2079,2061,2053,2051,2048,2043,2043,2051,2055,2063,2069,2069,2070,2067,2067,-12,16,10.957493630692499,1
2061,2053,2051,2048,2043,2043,2051,2055,2063,2069,2069,2070,2067,2067,2064,3,9,9.63228697563317,1
2053,2051,2048,2043,2043,2051,2055,2063,2069,2069,2070,2067,2067,2064,2065,12,2,9.767779881299733,1
2051,2048,2043,2043,2051,2055,2063,2069,2069,2070,2067,2067,2064,2065,2063,12,-6,9.704196441304585,1
2048,2043,2043,2051,2055,2063,2069,2069,2070,2067,2067,2064,2065,2063,2063,15,-6,9.471762545286158,1
2043,2043,2051,2055,2063,2069,2069,2070,2067,2067,2064,2065,2063,2063,2066,23,-4,8.969790569302209,1
2043,2051,2055,2063,2069,2069,2070,2067,2067,2064,2065,2063,2063,2066,2066,23,-1,7.478222350519508,1
2051,2055,2063,2069,2069,2070,2067,2067,2064,2065,2063,2063,2066,2066,2068,17,1,5.20713795806158,1
2055,2063,2069,2069,2070,2067,2067,2064,2065,2063,2063,2066,2066,2068,2069,14,5,3.775863193647627,1
2063,2069,2069,2070,2067,2067,2064,2065,2063,2063,2066,2066,2068,2069,2068,5,3,2.416215064536938,1
2069,2069,2070,2067,2067,2064,2065,2063,2063,2066,2066,2068,2069,2068,2063,-6,0,2.416215064536938,1
2069,2070,2067,2067,2064,2065,2063,2063,2066,2066,2068,2069,2068,2063,2065,-4,2,2.336052836975837,1
2070,2067,2067,2064,2065,2063,2063,2066,2066,2068,2069,2068,2063,2065,2059,-11,-7,2.8502297317601477,1
2067,2067,2064,2065,2063,2063,2066,2066,2068,2069,2068,2063,2065,2059,2064,-3,-2,2.587515815456612,1
2067,2064,2065,2063,2063,2066,2066,2068,2069,2068,2063,2065,2059,2064,2064,-3,-4,2.5485756993344526,1
2064,2065,2063,2063,2066,2066,2068,2069,2068,2063,2065,2059,2064,2064,2066,2,-3,2.503331114069145,0
2065,2063,2063,2066,2066,2068,2069,2068,2063,2065,2059,2064,2064,2066,2066,1,-2,2.5071326821120348,0
2063,2063,2066,2066,2068,2069,2068,2063,2065,2059,2064,2064,2066,2066,2068,5,5,2.6240644591385873,0
2063,2066,2066,2068,2069,2068,2063,2065,2059,2064,2064,2066,2066,2068,2068,5,3,2.6421491973301547,0
2066,2066,2068,2069,2068,2063,2065,2059,2064,2064,2066,2066,2068,2068,2068,2,9,2.614975188810639,0
2066,2068,2069,2068,2063,2065,2059,2064,2064,2066,2066,2068,2068,2068,2066,0,2,2.614975188810639,0
2068,2069,2068,2063,2065,2059,2064,2064,2066,2066,2068,2068,2068,2066,2314,246,250,64.12354147603337,0
2069,2068,2063,2065,2059,2064,2064,2066,2066,2068,2068,2068,2066,2314,2301,232,235,85.15738929993657,0
2068,2063,2065,2059,2064,2064,2066,2066,2068,2068,2068,2066,2314,2301,2318,250,252,101.76434027880765,0
2063,2065,2059,2064,2064,2066,2066,2068,2068,2068,2066,2314,2301,2318,2299,236,231,111.25547605570232,0
2065,2059,2064,2064,2066,2066,2068,2068,2068,2066,2314,2301,2318,2299,2270,205,202,115.13065042232093,0
2059,2064,2064,2066,2066,2068,2068,2068,2066,2314,2301,2318,2299,2270,2302,243,234,119.72460462403271,0
2064,2064,2066,2066,2068,2068,2068,2066,2314,2301,2318,2299,2270,2302,2305,241,239,121.8004613330852,0
2064,2066,2066,2068,2068,2068,2066,2314,2301,2318,2299,2270,2302,2305,2322,258,8,123.0748127108448,0
2066,2066,2068,2068,2068,2066,2314,2301,2318,2299,2270,2302,2305,2322,2309,243,8,120.95209598766581,0
2066,2068,2068,2068,2066,2314,2301,2318,2299,2270,2302,2305,2322,2309,2291,225,-27,115.72804738861255,0
2068,2068,2068,2066,2314,2301,2318,2299,2270,2302,2305,2322,2309,2291,2297,229,-2,108.26347931034248,0
2068,2068,2066,2314,2301,2318,2299,2270,2302,2305,2322,2309,2291,2297,2299,231,29,98.01418750558999,0
2068,2066,2314,2301,2318,2299,2270,2302,2305,2322,2309,2291,2297,2299,2302,234,0,83.64881236170547,0
2066,2314,2301,2318,2299,2270,2302,2305,2322,2309,2291,2297,2299,2302,2301,235,-4,62.159702150417125,0
2314,2301,2318,2299,2270,2302,2305,2322,2309,2291,2297,2299,2302,2301,2310,-4,-12,12.262991167776008,0
2301,2318,2299,2270,2302,2305,2322,2309,2291,2297,2299,2302,2301,2310,2307,6,-2,11.929555134802207,0
2318,2299,2270,2302,2305,2322,2309,2291,2297,2299,2302,2301,2310,2307,2312,-6,21,12.185862222068577,0
2299,2270,2302,2305,2322,2309,2291,2297,2299,2302,2301,2310,2307,2312,2300,1,3,11.460906637451547,0
2270,2302,2305,2322,2309,2291,2297,2299,2302,2301,2310,2307,2312,2300,2315,45,16,11.923566101273083,0
2302,2305,2322,2309,2291,2297,2299,2302,2301,2310,2307,2312,2300,2315,2306,4,4,7.738586065019519,0
2305,2322,2309,2291,2297,2299,2302,2301,2310,2307,2312,2300,2315,2306,2305,0,4,7.688581515096638,0
2322,2309,2291,2297,2299,2302,2301,2310,2307,2312,2300,2315,2306,2305,2291,-31,-19,8.542888995003528,0
2309,2291,2297,2299,2302,2301,2310,2307,2312,2300,2315,2306,2305,2291,2287,-22,-20,8.184189170648024,0
2291,2297,2299,2302,2301,2310,2307,2312,2300,2315,2306,2305,2291,2287,2300,9,-12,7.971974721007396,0
2297,2299,2302,2301,2310,2307,2312,2300,2315,2306,2305,2291,2287,2300,2275,-22,-25,10.232069101371339,0
2299,2302,2301,2310,2307,2312,2300,2315,2306,2305,2291,2287,2300,2275,2294,-5,-21,10.333486942022638,0
2302,2301,2310,2307,2312,2300,2315,2306,2305,2291,2287,2300,2275,2294,2290,-12,-16,10.668154658117954,0
2301,2310,2307,2312,2300,2315,2306,2305,2291,2287,2300,2275,2294,2290,2312,11,7,11.126972805283735,0
2310,2307,2312,2300,2315,2306,2305,2291,2287,2300,2275,2294,2290,2312,2290,-20,-1,11.438031798721816,0
2307,2312,2300,2315,2306,2305,2291,2287,2300,2275,2294,2290,2312,2290,2302,-5,15,11.099978549957823,0
2312,2300,2315,2306,2305,2291,2287,2300,2275,2294,2290,2312,2290,2302,2310,-2,10,11.27871995438861,0
2300,2315,2306,2305,2291,2287,2300,2275,2294,2290,2312,2290,2302,2310,2287,-13,12,11.108555261599053,0
2315,2306,2305,2291,2287,2300,2275,2294,2290,2312,2290,2302,2310,2287,2281,-34,-13,11.872336794093274,0
2306,2305,2291,2287,2300,2275,2294,2290,2312,2290,2302,2310,2287,2281,2290,-16,0,10.768118728560758,0
2305,2291,2287,2300,2275,2294,2290,2312,2290,2302,2310,2287,2281,2290,2302,-3,-10,10.513936329598783,0
2291,2287,2300,2275,2294,2290,2312,2290,2302,2310,2287,2281,2290,2302,2301,10,11,10.273868840528428,0
2287,2300,2275,2294,2290,2312,2290,2302,2310,2287,2281,2290,2302,2301,2302,15,0,10.4257008443192,0
2300,2275,2294,2290,2312,2290,2302,2310,2287,2281,2290,2302,2301,2302,2300,0,-10,10.264130793807187,0
2275,2294,2290,2312,2290,2302,2310,2287,2281,2290,2302,2301,2302,2300,2296,21,9,10.197105098063489,0
2294,2290,2312,2290,2302,2310,2287,2281,2290,2302,2301,2302,2300,2296,2292,-2,11,8.575713214821095,0
2290,2312,2290,2302,2310,2287,2281,2290,2302,2301,2302,2300,2296,2292,2290,0,0,8.723258456290177,0
2312,2290,2302,2310,2287,2281,2290,2302,2301,2302,2300,2296,2292,2290,2291,-21,-11,8.675087484120425,0
2290,2302,2310,2287,2281,2290,2302,2301,2302,2300,2296,2292,2290,2291,2301,11,0,7.668736780560656,0
2302,2310,2287,2281,2290,2302,2301,2302,2300,2296,2292,2290,2291,2301,2291,-11,-11,7.620148729957092,0
2310,2287,2281,2290,2302,2301,2302,2300,2296,2292,2290,2291,2301,2291,2277,-33,-23,8.795020236041584,0
2287,2281,2290,2302,2301,2302,2300,2296,2292,2290,2291,2301,2291,2277,2298,11,2,7.722570507162446,0
2281,2290,2302,2301,2302,2300,2296,2292,2290,2291,2301,2291,2277,2298,2304,23,12,7.98033296834877,0
2290,2302,2301,2302,2300,2296,2292,2290,2291,2301,2291,2277,2298,2304,2291,1,1,7.156082993476516,0
2302,2301,2302,2300,2296,2292,2290,2291,2301,2291,2277,2298,2304,2291,2310,8,19,7.962411694957753,0
2301,2302,2300,2296,2292,2290,2291,2301,2291,2277,2298,2304,2291,2310,2291,-10,-10,7.916228058025278,0
2302,2300,2296,2292,2290,2291,2301,2291,2277,2298,2304,2291,2310,2291,2286,-16,-5,8.138678961483567,0
2300,2296,2292,2290,2291,2301,2291,2277,2298,2304,2291,2310,2291,2286,2292,-8,15,7.901175319442762,0
2296,2292,2290,2291,2301,2291,2277,2298,2304,2291,2310,2291,2286,2292,2299,3,1,7.85099326442809,0
2292,2290,2291,2301,2291,2277,2298,2304,2291,2310,2291,2286,2292,2299,2279,-13,-25,8.711240685787203,0
2290,2291,2301,2291,2277,2298,2304,2291,2310,2291,2286,2292,2299,2279,2305,15,14,9.255628917943213,0
2291,2301,2291,2277,2298,2304,2291,2310,2291,2286,2292,2299,2279,2305,2308,17,-2,9.891314130998733,0
2301,2291,2277,2298,2304,2291,2310,2291,2286,2292,2299,2279,2305,2308,2291,-10,0,9.891314130998733,0
2291,2277,2298,2304,2291,2310,2291,2286,2292,2299,2279,2305,2308,2291,2309,18,23,10.44577836804351,0
2277,2298,2304,2291,2310,2291,2286,2292,2299,2279,2305,2308,2291,2309,2271,-6,-21,12.17999921807801,0
2298,2304,2291,2310,2291,2286,2292,2299,2279,2305,2308,2291,2309,2271,2286,-12,-13,11.480832888319723,0
2304,2291,2310,2291,2286,2292,2299,2279,2305,2308,2291,2309,2271,2286,2311,7,32,12.21747382508621,0
2291,2310,2291,2286,2292,2299,2279,2305,2308,2291,2309,2271,2286,2311,2282,-9,-23,12.446839338716055,0
2310,2291,2286,2292,2299,2279,2305,2308,2291,2309,2271,2286,2311,2282,2278,-32,-30,13.110519222582845,0
2291,2286,2292,2299,2279,2305,2308,2291,2309,2271,2286,2311,2282,2278,2302,11,11,12.52806373516598,0
2286,2292,2299,2279,2305,2308,2291,2309,2271,2286,2311,2282,2278,2302,2309,23,0,13.201010062365178,0
2292,2299,2279,2305,2308,2291,2309,2271,2286,2311,2282,2278,2302,2309,2268,-24,-3,14.700178165425005,0
2299,2279,2305,2308,2291,2309,2271,2286,2311,2282,2278,2302,2309,2268,2301,2,15,14.853891585644996,0
2279,2305,2308,2291,2309,2271,2286,2311,2282,2278,2302,2309,2268,2301,2299,20,-12,14.853891585644996,0
2305,2308,2291,2309,2271,2286,2311,2282,2278,2302,2309,2268,2301,2299,2317,12,35,15.474402827157592,0
2308,2291,2309,2271,2286,2311,2282,2278,2302,2309,2268,2301,2299,2317,2302,-6,24,15.366010728692263,0
2291,2309,2271,2286,2311,2282,2278,2302,2309,2268,2301,2299,2317,2302,2282,-9,-20,15.333747406417308,0
2309,2271,2286,2311,2282,2278,2302,2309,2268,2301,2299,2317,2302,2282,2287,-22,-22,15.42169158777893,0
2271,2286,2311,2282,2278,2302,2309,2268,2301,2299,2317,2302,2282,2287,2307,36,39,15.287093840728463,0
2286,2311,2282,2278,2302,2309,2268,2301,2299,2317,2302,2282,2287,2307,2302,16,1,14.080719678577038,0
2311,2282,2278,2302,2309,2268,2301,2299,2317,2302,2282,2287,2307,2302,2305,-6,6,14.016317021855023,0
2282,2278,2302,2309,2268,2301,2299,2317,2302,2282,2287,2307,2302,2305,2285,3,-32,13.739758090335958,0
2278,2302,2309,2268,2301,2299,2317,2302,2282,2287,2307,2302,2305,2285,2303,25,1,13.378376298376136,0
2302,2309,2268,2301,2299,2317,2302,2282,2287,2307,2302,2305,2285,2303,2304,2,22,12.468245380050188,0
2309,2268,2301,2299,2317,2302,2282,2287,2307,2302,2305,2285,2303,2304,2301,-8,14,12.44913460369645,0
2268,2301,2299,2317,2302,2282,2287,2307,2302,2305,2285,2303,2304,2301,2312,44,5,12.658518682614298,0
2301,2299,2317,2302,2282,2287,2307,2302,2305,2285,2303,2304,2301,2312,2296,-5,-6,9.548373085056353,0
2299,2317,2302,2282,2287,2307,2302,2305,2285,2303,2304,2301,2312,2296,2281,-18,-24,10.749529336318913,0
2317,2302,2282,2287,2307,2302,2305,2285,2303,2304,2301,2312,2296,2281,2311,-6,26,11.197363635291675,0
2302,2282,2287,2307,2302,2305,2285,2303,2304,2301,2312,2296,2281,2311,2299,-3,-4,10.11975907863047,0
2282,2287,2307,2302,2305,2285,2303,2304,2301,2312,2296,2281,2311,2299,2298,16,-6,10.072593650949235,0
2287,2307,2302,2305,2285,2303,2304,2301,2312,2296,2281,2311,2299,2298,2300,13,-1,9.02219485491197,0
2307,2302,2305,2285,2303,2304,2301,2312,2296,2281,2311,2299,2298,2300,2275,-32,-37,10.595147137116259,0
2302,2305,2285,2303,2304,2301,2312,2296,2281,2311,2299,2298,2300,2275,2294,-8,-2,10.388638482679506,0
2305,2285,2303,2304,2301,2312,2296,2281,2311,2299,2298,2300,2275,2294,2307,2,26,10.613109593238695,0
2285,2303,2304,2301,2312,2296,2281,2311,2299,2298,2300,2275,2294,2307,2284,-1,-27,11.010817192111366,0
2303,2304,2301,2312,2296,2281,2311,2299,2298,2300,2275,2294,2307,2284,2294,-9,-5,10.565893016593309,0
2304,2301,2312,2296,2281,2311,2299,2298,2300,2275,2294,2307,2284,2294,2295,-9,-3,10.457168878447979,0
2301,2312,2296,2281,2311,2299,2298,2300,2275,2294,2307,2284,2294,2295,2287,-14,-13,10.534297725592749,0
2312,2296,2281,2311,2299,2298,2300,2275,2294,2307,2284,2294,2295,2287,2282,-30,7,10.971825389649272,0
2296,2281,2311,2299,2298,2300,2275,2294,2307,2284,2294,2295,2287,2282,2300,4,6,9.984750277059417,0
2281,2311,2299,2298,2300,2275,2294,2307,2284,2294,2295,2287,2282,2300,2298,17,-9,10.03327796219494,0
2311,2299,2298,2300,2275,2294,2307,2284,2294,2295,2287,2282,2300,2298,2298,-13,14,9.443062457244926,0
2299,2298,2300,2275,2294,2307,2284,2294,2295,2287,2282,2300,2298,2298,2294,-5,0,8.312354545809393,0
2298,2300,2275,2294,2307,2284,2294,2295,2287,2282,2300,2298,2298,2294,2360,62,65,19.069297187838238,0
2300,2275,2294,2307,2284,2294,2295,2287,2282,2300,2298,2298,2294,2360,2335,35,48,21.361514125040053,0
2275,2294,2307,2284,2294,2295,2287,2282,2300,2298,2298,2294,2360,2335,2348,73,66,24.668661438003827,0
2294,2307,2284,2294,2295,2287,2282,2300,2298,2298,2294,2360,2335,2348,2326,32,26,23.97975336463183,0
2307,2284,2294,2295,2287,2282,2300,2298,2298,2294,2360,2335,2348,2326,2330,23,32,24.40491753725056,0
2284,2294,2295,2287,2282,2300,2298,2298,2294,2360,2335,2348,2326,2330,2341,57,43,25.728990504505855,0
2294,2295,2287,2282,2300,2298,2298,2294,2360,2335,2348,2326,2330,2341,2360,66,66,27.364906271319388,0
2295,2287,2282,2300,2298,2298,2294,2360,2335,2348,2326,2330,2341,2360,2380,85,20,31.0655221534528,0
2287,2282,2300,2298,2298,2294,2360,2335,2348,2326,2330,2341,2360,2380,2350,63,15,30.86252157707205,0
2282,2300,2298,2298,2294,2360,2335,2348,2326,2330,2341,2360,2380,2350,2395,113,47,33.6066886766537,0
2300,2298,2298,2294,2360,2335,2348,2326,2330,2341,2360,2380,2350,2395,2363,63,37,31.22697246810535,0
2298,2298,2294,2360,2335,2348,2326,2330,2341,2360,2380,2350,2395,2363,2386,88,56,31.540148261873348,0
2298,2294,2360,2335,2348,2326,2330,2341,2360,2380,2350,2395,2363,2386,2350,52,9,28.833181942900108,0
2294,2360,2335,2348,2326,2330,2341,2360,2380,2350,2395,2363,2386,2350,2355,61,-5,25.357069081046266,0
2360,2335,2348,2326,2330,2341,2360,2380,2350,2395,2363,2386,2350,2355,2361,1,-19,19.78816385042909,0
2335,2348,2326,2330,2341,2360,2380,2350,2395,2363,2386,2350,2355,2361,2356,21,6,19.757337395316732,0
2348,2326,2330,2341,2360,2380,2350,2395,2363,2386,2350,2355,2361,2356,2367,19,-28,19.0745404987406,0
2326,2330,2341,2360,2380,2350,2395,2363,2386,2350,2355,2361,2356,2367,2326,0,-37,20.666743471439464,0
2330,2341,2360,2380,2350,2395,2363,2386,2350,2355,2361,2356,2367,2326,2383,53,-3,19.90405558099727,0
2341,2360,2380,2350,2395,2363,2386,2350,2355,2361,2356,2367,2326,2383,2354,13,4,18.194190595587685,0
2360,2380,2350,2395,2363,2386,2350,2355,2361,2356,2367,2326,2383,2354,2369,9,14,17.32325714452216,0
2380,2350,2395,2363,2386,2350,2355,2361,2356,2367,2326,2383,2354,2369,2346,-34,-15,17.902380794051894,0
2350,2395,2363,2386,2350,2355,2361,2356,2367,2326,2383,2354,2369,2346,2370,20,14,17.392390235250534,0
2395,2363,2386,2350,2355,2361,2356,2367,2326,2383,2354,2369,2346,2370,2355,-40,-12,17.191359956177322,0
2363,2386,2350,2355,2361,2356,2367,2326,2383,2354,2369,2346,2370,2355,2345,-18,19,15.14438446924737,0
2386,2350,2355,2361,2356,2367,2326,2383,2354,2369,2346,2370,2355,2345,2322,-64,-61,17.843232677431306,0
2350,2355,2361,2356,2367,2326,2383,2354,2369,2346,2370,2355,2345,2322,2348,-2,-6,15.924823389915506,0
2355,2361,2356,2367,2326,2383,2354,2369,2346,2370,2355,2345,2322,2348,2349,-6,-20,15.943949442014793,0
2361,2356,2367,2326,2383,2354,2369,2346,2370,2355,2345,2322,2348,2349,2373,12,27,16.705288583758936,0
2356,2367,2326,2383,2354,2369,2346,2370,2355,2345,2322,2348,2349,2373,2346,-10,-24,16.765042996266565,0
2367,2326,2383,2354,2369,2346,2370,2355,2345,2322,2348,2349,2373,2346,2336,-31,-19,17.37321419394153,0
2326,2383,2354,2369,2346,2370,2355,2345,2322,2348,2349,2373,2346,2336,2370,44,25,17.567014544310027,0
2383,2354,2369,2346,2370,2355,2345,2322,2348,2349,2373,2346,2336,2370,2359,-24,37,15.964245765370277,0
2354,2369,2346,2370,2355,2345,2322,2348,2349,2373,2346,2336,2370,2359,2328,-26,-20,15.379330594138665,0
2369,2346,2370,2355,2345,2322,2348,2349,2373,2346,2336,2370,2359,2328,2350,-19,1,15.364461157706334,0
2346,2370,2355,2345,2322,2348,2349,2373,2346,2336,2370,2359,2328,2350,2339,-7,-34,14.805726048037084,0
2370,2355,2345,2322,2348,2349,2373,2346,2336,2370,2359,2328,2350,2339,2350,-20,4,14.782550846312335,0
2355,2345,2322,2348,2349,2373,2346,2336,2370,2359,2328,2350,2339,2350,2366,11,30,14.414608991608214,0
2345,2322,2348,2349,2373,2346,2336,2370,2359,2328,2350,2339,2350,2366,2326,-19,-44,15.46824704569547,0
2322,2348,2349,2373,2346,2336,2370,2359,2328,2350,2339,2350,2366,2326,2349,27,-10,15.463320656129644,0
2348,2349,2373,2346,2336,2370,2359,2328,2350,2339,2350,2366,2326,2349,2371,23,43,14.878876045620931,0
2349,2373,2346,2336,2370,2359,2328,2350,2339,2350,2366,2326,2349,2371,2309,-40,-41,18.374931162812427,0
2373,2346,2336,2370,2359,2328,2350,2339,2350,2366,2326,2349,2371,2309,2339,-34,0,18.519487805320875,0
2346,2336,2370,2359,2328,2350,2339,2350,2366,2326,2349,2371,2309,2339,2352,6,2,17.19219091830441,0
2336,2370,2359,2328,2350,2339,2350,2366,2326,2349,2371,2309,2339,2352,2344,8,-22,17.19994462892527,0
2370,2359,2328,2350,2339,2350,2366,2326,2349,2371,2309,2339,2352,2344,2320,-50,-6,18.315489151457104,0
2359,2328,2350,2339,2350,2366,2326,2349,2371,2309,2339,2352,2344,2320,2330,-29,-19,17.26626217581007,0
2328,2350,2339,2350,2366,2326,2349,2371,2309,2339,2352,2344,2320,2330,2348,20,-23,16.723806812018438,2
2350,2339,2350,2366,2326,2349,2371,2309,2339,2352,2344,2320,2330,2348,2122,-228,-187,59.186951586437004,2
2339,2350,2366,2326,2349,2371,2309,2339,2352,2344,2320,2330,2348,2122,2123,-216,-216,78.82971400128133,2
2350,2366,2326,2349,2371,2309,2339,2352,2344,2320,2330,2348,2122,2123,2126,-224,-226,91.83344136196222,2
2366,2326,2349,2371,2309,2339,2352,2344,2320,2330,2348,2122,2123,2126,2126,-240,-218,100.62362687616803,2
2326,2349,2371,2309,2339,2352,2344,2320,2330,2348,2122,2123,2126,2126,2124,-202,-196,105.70610650469041,2
2349,2371,2309,2339,2352,2344,2320,2330,2348,2122,2123,2126,2126,2124,2121,-228,-209,110.70411013146712,2
2371,2309,2339,2352,2344,2320,2330,2348,2122,2123,2126,2126,2124,2121,2121,-250,-227,112.31066607533639,2
2309,2339,2352,2344,2320,2330,2348,2122,2123,2126,2126,2124,2121,2121,2122,-187,0,109.68278937788865,2
2339,2352,2344,2320,2330,2348,2122,2123,2126,2126,2124,2121,2121,2122,2125,-214,2,109.52290475816767,2
2352,2344,2320,2330,2348,2122,2123,2126,2126,2124,2121,2121,2122,2125,2127,-225,1,105.21664724340373,2
2344,2320,2330,2348,2122,2123,2126,2126,2124,2121,2121,2122,2125,2127,2132,-212,6,96.82714101993943,2
2320,2330,2348,2122,2123,2126,2126,2124,2121,2121,2122,2125,2127,2132,2134,-186,10,86.12488164343239,2
2330,2348,2122,2123,2126,2126,2124,2121,2121,2122,2125,2127,2132,2134,2133,-197,12,75.19542792585452,2
2348,2122,2123,2126,2126,2124,2121,2121,2122,2125,2127,2132,2134,2133,2132,-216,11,57.42133335102489,2
2122,2123,2126,2126,2124,2121,2121,2122,2125,2127,2132,2134,2133,2132,2132,10,10,4.715728494951256,0
2123,2126,2126,2124,2121,2121,2122,2125,2127,2132,2134,2133,2132,2132,2127,4,2,4.535573676110727,0
2126,2126,2124,2121,2121,2122,2125,2127,2132,2134,2133,2132,2132,2127,2127,1,0,4.399134113934349,0
2126,2124,2121,2121,2122,2125,2127,2132,2134,2133,2132,2132,2127,2127,2128,2,-4,4.38829612231705,0
2124,2121,2121,2122,2125,2127,2132,2134,2133,2132,2132,2127,2127,2128,2128,4,-6,4.3730778090275875,0
2121,2121,2122,2125,2127,2132,2134,2133,2132,2132,2127,2127,2128,2128,2132,11,-1,4.399134113934349,0
2121,2122,2125,2127,2132,2134,2133,2132,2132,2127,2127,2128,2128,2132,2134,13,2,4.182730937466346,0
2122,2125,2127,2132,2134,2133,2132,2132,2127,2127,2128,2128,2132,2134,2137,15,5,4.053217416888888,0
2125,2127,2132,2134,2133,2132,2132,2127,2127,2128,2128,2132,2134,2137,2138,13,11,3.899938949461108,0
2127,2132,2134,2133,2132,2132,2127,2127,2128,2128,2132,2134,2137,2138,2134,7,7,3.5790395093549625,0
2132,2134,2133,2132,2132,2127,2127,2128,2128,2132,2134,2137,2138,2134,2133,1,5,3.348062694981056,0
2134,2133,2132,2132,2127,2127,2128,2128,2132,2134,2137,2138,2134,2133,2130,-4,2,3.390462814312833,0
2133,2132,2132,2127,2127,2128,2128,2132,2134,2137,2138,2134,2133,2130,2130,-3,-2,3.373566715058764,0
2132,2132,2127,2127,2128,2128,2132,2134,2137,2138,2134,2133,2130,2130,2128,-4,-6,3.4778208831448025,0
2132,2127,2127,2128,2128,2132,2134,2137,2138,2134,2133,2130,2130,2128,2132,0,-5,3.4778208831448025,0
2127,2127,2128,2128,2132,2134,2137,2138,2134,2133,2130,2130,2128,2132,2132,5,-6,3.4778208831448025,0
2127,2128,2128,2132,2134,2137,2138,2134,2133,2130,2130,2128,2132,2132,2134,7,0,3.320929301953209,0
2128,2128,2132,2134,2137,2138,2134,2133,2130,2130,2128,2132,2132,2134,2139,11,6,3.521363372331802,0
2128,2132,2134,2137,2138,2134,2133,2130,2130,2128,2132,2132,2134,2139,2137,9,7,3.4475664294853385,0
2132,2134,2137,2138,2134,2133,2130,2130,2128,2132,2132,2134,2139,2137,2135,3,5,3.154739442867026,0
2134,2137,2138,2134,2133,2130,2130,2128,2132,2132,2134,2139,2137,2135,2136,2,8,3.1728010758108782,0
2137,2138,2134,2133,2130,2130,2128,2132,2132,2134,2139,2137,2135,2136,2131,-6,-1,3.2616093018777153,0
2138,2134,2133,2130,2130,2128,2132,2132,2134,2139,2137,2135,2136,2131,2130,-8,-2,3.2616093018777153,0
2134,2133,2130,2130,2128,2132,2132,2134,2139,2137,2135,2136,2131,2130,2129,-5,-5,3.154739442867026,0
2133,2130,2130,2128,2132,2132,2134,2139,2137,2135,2136,2131,2130,2129,2131,-2,-8,3.1592645316516914,0
2130,2130,2128,2132,2132,2134,2139,2137,2135,2136,2131,2130,2129,2131,2134,4,-3,3.1817934445544265,0
2130,2128,2132,2132,2134,2139,2137,2135,2136,2131,2130,2129,2131,2134,2135,5,0,3.1592645316516914,0
2128,2132,2132,2134,2139,2137,2135,2136,2131,2130,2129,2131,2134,2135,2138,10,2,3.3123146848433,0
2132,2132,2134,2139,2137,2135,2136,2131,2130,2129,2131,2134,2135,2138,2139,7,8,3.24844285041017,0
2132,2134,2139,2137,2135,2136,2131,2130,2129,2131,2134,2135,2138,2139,2138,6,8,3.3352375513311676,0
2134,2139,2137,2135,2136,2131,2130,2129,2131,2134,2135,2138,2139,2138,2137,3,8,3.313752009573496,0
2139,2137,2135,2136,2131,2130,2129,2131,2134,2135,2138,2139,2138,2137,2135,-4,4,3.305118685283408,0
2137,2135,2136,2131,2130,2129,2131,2134,2135,2138,2139,2138,2137,2135,2131,-6,-3,3.2469766156929962,0
2135,2136,2131,2130,2129,2131,2134,2135,2138,2139,2138,2137,2135,2131,2133,-2,-2,3.1817934445544265,0
2136,2131,2130,2129,2131,2134,2135,2138,2139,2138,2137,2135,2131,2133,2133,-3,-5,3.1847852585154217,0
2131,2130,2129,2131,2134,2135,2138,2139,2138,2137,2135,2131,2133,2133,2133,2,-6,3.1441555759399513,0
2130,2129,2131,2134,2135,2138,2139,2138,2137,2135,2131,2133,2133,2133,2138,8,0,3.2175116087406668,0
2129,2131,2134,2135,2138,2139,2138,2137,2135,2131,2133,2133,2133,2138,2140,11,3,3.305118685283408,0
2131,2134,2135,2138,2139,2138,2137,2135,2131,2133,2133,2133,2138,2140,2141,10,6,3.2175116087406668,0
2134,2135,2138,2139,2138,2137,2135,2131,2133,2133,2133,2138,2140,2141,2140,6,9,3.1091263510296048,0
2135,2138,2139,2138,2137,2135,2131,2133,2133,2133,2138,2140,2141,2140,2140,5,7,3.1728010758108782,0
2138,2139,2138,2137,2135,2131,2133,2133,2133,2138,2140,2141,2140,2140,2137,-1,4,3.136573805618997,0
2139,2138,2137,2135,2131,2133,2133,2133,2138,2140,2141,2140,2140,2137,2134,-5,1,3.2026774513120824,0
2138,2137,2135,2131,2133,2133,2133,2138,2140,2141,2140,2140,2137,2134,2134,-4,-4,3.1952345468719208,0
2137,2135,2131,2133,2133,2133,2138,2140,2141,2140,2140,2137,2134,2134,2136,-1,-4,3.1592645316516914,0
2135,2131,2133,2133,2133,2138,2140,2141,2140,2140,2137,2134,2134,2136,2137,2,-4,3.1592645316516914,0
2131,2133,2133,2133,2138,2140,2141,2140,2140,2137,2134,2134,2136,2137,2138,7,-2,3.1773004414499577,0
2133,2133,2133,2138,2140,2141,2140,2140,2137,2134,2134,2136,2137,2138,2142,9,2,3.1274514194392182,0
2133,2133,2138,2140,2141,2140,2140,2137,2134,2134,2136,2137,2138,2142,2142,9,5,3.154739442867026,0
2133,2138,2140,2141,2140,2140,2137,2134,2134,2136,2137,2138,2142,2142,2142,9,8,3.0581662728473336,0
2138,2140,2141,2140,2140,2137,2134,2134,2136,2137,2138,2142,2142,2142,2142,4,8,2.8250579429371676,0
2140,2141,2140,2140,2137,2134,2134,2136,2137,2138,2142,2142,2142,2142,2142,2,6,2.9244454093692624,0
2141,2140,2140,2137,2134,2134,2136,2137,2138,2142,2142,2142,2142,2142,2138,-3,1,2.9277002188455996,0
2140,2140,2137,2134,2134,2136,2137,2138,2142,2142,2142,2142,2142,2138,2140,0,2,2.8900486072695997,0
2140,2137,2134,2134,2136,2137,2138,2142,2142,2142,2142,2142,2138,2140,2139,-1,-3,2.875181153713043,0
2137,2134,2134,2136,2137,2138,2142,2142,2142,2142,2142,2138,2140,2139,2144,7,2,3.1592645316516914,0
2134,2134,2136,2137,2138,2142,2142,2142,2142,2142,2138,2140,2139,2144,2145,11,3,3.4364987719368982,0
2134,2136,2137,2138,2142,2142,2142,2142,2142,2138,2140,2139,2144,2145,2149,15,7,3.8297084310253524,0
2136,2137,2138,2142,2142,2142,2142,2142,2138,2140,2139,2144,2145,2149,2149,13,7,3.9218557317872342,0
2137,2138,2142,2142,2142,2142,2142,2138,2140,2139,2144,2145,2149,2149,2149,12,11,4.015446366695678,0
2138,2142,2142,2142,2142,2142,2138,2140,2139,2144,2145,2149,2149,2149,2147,9,7,3.858200913082973,0
2142,2142,2142,2142,2142,2138,2140,2139,2144,2145,2149,2149,2149,2147,2147,5,8,3.687817782917155,0
2142,2142,2142,2142,2138,2140,2139,2144,2145,2149,2149,2149,2147,2147,2145,3,1,3.6645015252516173,0
2142,2142,2142,2138,2140,2139,2144,2145,2149,2149,2149,2147,2147,2145,2145,3,0,3.629246281451367,0
2142,2142,2138,2140,2139,2144,2145,2149,2149,2149,2147,2147,2145,2145,2146,4,-3,3.602908877692077,0
2142,2138,2140,2139,2144,2145,2149,2149,2149,2147,2147,2145,2145,2146,2150,8,1,3.7984959429452374,0
2138,2140,2139,2144,2145,2149,2149,2149,2147,2147,2145,2145,2146,2150,2151,13,2,3.996426975615665,0
2140,2139,2144,2145,2149,2149,2149,2147,2147,2145,2145,2146,2150,2151,2152,12,5,3.7199590371528606,0
2139,2144,2145,2149,2149,2149,2147,2147,2145,2145,2146,2150,2151,2152,2155,16,8,3.852024823141102,0
2144,2145,2149,2149,2149,2147,2147,2145,2145,2146,2150,2151,2152,2155,2149,5,4,3.051931472737505,0
2145,2149,2149,2149,2147,2147,2145,2145,2146,2150,2151,2152,2155,2149,2149,4,4,2.8250579429371676,0
2149,2149,2149,2147,2147,2145,2145,2146,2150,2151,2152,2155,2149,2149,2144,-5,-2,2.9244454093692624,0
2149,2149,2147,2147,2145,2145,2146,2150,2151,2152,2155,2149,2149,2144,2143,-6,-7,3.2396354880199247,0
2149,2147,2147,2145,2145,2146,2150,2151,2152,2155,2149,2149,2144,2143,2134,-15,-17,4.847188679558296,0
2147,2147,2145,2145,2146,2150,2151,2152,2155,2149,2149,2144,2143,2134,2134,-13,-18,5.861090423494672,0
2147,2145,2145,2146,2150,2151,2152,2155,2149,2149,2144,2143,2134,2134,2119,-28,-36,9.10415917510861,0
2145,2145,2146,2150,2151,2152,2155,2149,2149,2144,2143,2134,2134,2119,2117,-28,-32,11.440529458277458,0
2145,2146,2150,2151,2152,2155,2149,2149,2144,2143,2134,2134,2119,2117,2108,-37,-41,14.399735447305307,0
2146,2150,2151,2152,2155,2149,2149,2144,2143,2134,2134,2119,2117,2108,2108,-38,-36,16.45542319057618,0
2150,2151,2152,2155,2149,2149,2144,2143,2134,2134,2119,2117,2108,2108,2081,-69,-62,21.710651324923003,0
2151,2152,2155,2149,2149,2144,2143,2134,2134,2119,2117,2108,2108,2081,2108,-43,-26,22.05793238162591,0
2152,2155,2149,2149,2144,2143,2134,2134,2119,2117,2108,2108,2081,2108,2138,-14,4,21.425841095897884,0
2155,2149,2149,2144,2143,2134,2134,2119,2117,2108,2108,2081,2108,2138,2139,-16,20,20.6909227854701,0
2149,2149,2144,2143,2134,2134,2119,2117,2108,2108,2081,2108,2138,2139,2127,-22,10,19.338587135076658,0
2149,2144,2143,2134,2134,2119,2117,2108,2108,2081,2108,2138,2139,2127,2134,-15,26,18.461800974934576,0
2144,2143,2134,2134,2119,2117,2108,2108,2081,2108,2138,2139,2127,2134,2126,-18,18,17.291616465790582,0
2143,2134,2134,2119,2117,2108,2108,2081,2108,2138,2139,2127,2134,2126,2079,-64,-2,19.873408891088136,0
2134,2134,2119,2117,2108,2108,2081,2108,2138,2139,2127,2134,2126,2079,2095,-39,-13,19.711732063732526,0
2134,2119,2117,2108,2108,2081,2108,2138,2139,2127,2134,2126,2079,2095,2094,-40,-44,19.875325693647675,0
2119,2117,2108,2108,2081,2108,2138,2139,2127,2134,2126,2079,2095,2094,2085,-34,-54,20.33949945537594,0
2117,2108,2108,2081,2108,2138,2139,2127,2134,2126,2079,2095,2094,2085,2091,-26,-36,20.786900637065596,0
2108,2108,2081,2108,2138,2139,2127,2134,2126,2079,2095,2094,2085,2091,2095,-13,-39,20.93254472278582,0
2108,2081,2108,2138,2139,2127,2134,2126,2079,2095,2094,2085,2091,2095,2094,-14,-32,21.20467154280149,0
2081,2108,2138,2139,2127,2134,2126,2079,2095,2094,2085,2091,2095,2094,2093,12,14,21.469136208143297,0
2108,2138,2139,2127,2134,2126,2079,2095,2094,2085,2091,2095,2094,2093,2110,2,15,20.407281613608973,0
2138,2139,2127,2134,2126,2079,2095,2094,2085,2091,2095,2094,2093,2110,2120,-18,26,20.67434573157205,0
2139,2127,2134,2126,2079,2095,2094,2085,2091,2095,2094,2093,2110,2120,2123,-16,38,19.44589563745669,0
2127,2134,2126,2079,2095,2094,2085,2091,2095,2094,2093,2110,2120,2123,2124,-3,33,18.015866023353652,0
2134,2126,2079,2095,2094,2085,2091,2095,2094,2093,2110,2120,2123,2124,2125,-9,30,17.856038061062012,0
2126,2079,2095,2094,2085,2091,2095,2094,2093,2110,2120,2123,2124,2125,2127,1,33,17.145595019462828,0
2079,2095,2094,2085,2091,2095,2094,2093,2110,2120,2123,2124,2125,2127,2124,45,31,16.98094169804434,0
2095,2094,2085,2091,2095,2094,2093,2110,2120,2123,2124,2125,2127,2124,2124,29,14,15.952906885431197,0
2094,2085,2091,2095,2094,2093,2110,2120,2123,2124,2125,2127,2124,2124,2123,29,3,15.92781334946006,0
2085,2091,2095,2094,2093,2110,2120,2123,2124,2125,2127,2124,2124,2123,2124,39,1,15.638170639572294,0
2091,2095,2094,2093,2110,2120,2123,2124,2125,2127,2124,2124,2123,2124,2126,35,2,14.060413866427904,0
2095,2094,2093,2110,2120,2123,2124,2125,2127,2124,2124,2123,2124,2126,2123,28,-2,12.524262168173536,0
2094,2093,2110,2120,2123,2124,2125,2127,2124,2124,2123,2124,2126,2123,2126,32,-1,11.112841135157026,0
2093,2110,2120,2123,2124,2125,2127,2124,2124,2123,2124,2126,2123,2126,2124,31,0,8.721620644505622,0
2110,2120,2123,2124,2125,2127,2124,2124,2123,2124,2126,2123,2126,2124,2124,14,0,3.979710446514324,1
2120,2123,2124,2125,2127,2124,2124,2123,2124,2126,2123,2126,2124,2124,2126,6,3,1.6987390281365427,1
2123,2124,2125,2127,2124,2124,2123,2124,2126,2123,2126,2124,2124,2126,2124,1,0,1.245945806357946,1
2124,2125,2127,2124,2124,2123,2124,2126,2123,2126,2124,2124,2126,2124,2124,0,-2,1.1872336794093274,1
2125,2127,2124,2124,2123,2124,2126,2123,2126,2124,2124,2126,2124,2124,2122,-3,-1,1.3522468075656267,1
2127,2124,2124,2123,2124,2126,2123,2126,2124,2124,2126,2124,2124,2122,2121,-6,-5,1.5976172734359604,1
2124,2124,2123,2124,2126,2123,2126,2124,2124,2126,2124,2124,2122,2121,2122,-2,-2,1.4735767952260144,1
2124,2123,2124,2126,2123,2126,2124,2124,2126,2124,2124,2122,2121,2122,2122,-2,-2,1.5430334996209192,1
2123,2124,2126,2123,2126,2124,2124,2126,2124,2124,2122,2121,2122,2122,2121,-2,-5,1.6846647257229665,1
2124,2126,2123,2126,2124,2124,2126,2124,2124,2122,2121,2122,2122,2121,2125,1,1,1.7237832147426693,1
2126,2123,2126,2124,2124,2126,2124,2124,2122,2121,2122,2122,2121,2125,2123,-3,-1,1.7265434778633235,1
2123,2126,2124,2124,2126,2124,2124,2122,2121,2122,2122,2121,2125,2123,2124,1,2,1.5946338585572373,1
2126,2124,2124,2126,2124,2124,2122,2121,2122,2122,2121,2125,2123,2124,2124,-2,3,1.5976172734359606,1
2124,2124,2126,2124,2124,2122,2121,2122,2122,2121,2125,2123,2124,2124,2124,0,2,1.4474937289114918,1
2124,2126,2124,2124,2122,2121,2122,2122,2121,2125,2123,2124,2124,2124,2122,-2,0,1.4735767952260144,1
2126,2124,2124,2122,2121,2122,2122,2121,2125,2123,2124,2124,2124,2122,2121,-5,0,1.558387444947959,0
2124,2124,2122,2121,2122,2122,2121,2125,2123,2124,2124,2124,2122,2121,2122,-2,-3,1.3345232785352157,0
2124,2122,2121,2122,2122,2121,2125,2123,2124,2124,2124,2122,2121,2122,2124,0,1,1.3345232785352157,0
2122,2121,2122,2122,2121,2125,2123,2124,2124,2124,2122,2121,2122,2124,2124,2,0,1.3345232785352157,0
2121,2122,2122,2121,2125,2123,2124,2124,2124,2122,2121,2122,2124,2124,2123,2,-1,1.3201731488169053,0
2122,2122,2121,2125,2123,2124,2124,2124,2122,2121,2122,2124,2124,2123,2124,2,0,1.2535663410560174,0
2122,2121,2125,2123,2124,2124,2124,2122,2121,2122,2124,2124,2123,2124,2362,240,240,61.70320667749541,0
2121,2125,2123,2124,2124,2124,2122,2121,2122,2124,2124,2123,2124,2362,2330,209,209,78.65373178565352,0
2125,2123,2124,2124,2124,2122,2121,2122,2124,2124,2123,2124,2362,2330,2348,223,226,92.67300423686346,0
2123,2124,2124,2124,2122,2121,2122,2124,2124,2123,2124,2362,2330,2348,2337,214,213,101.40151215177546,0
2124,2124,2124,2122,2121,2122,2124,2124,2123,2124,2362,2330,2348,2337,2370,246,246,110.73830154274279,0
2124,2124,2122,2121,2122,2124,2124,2123,2124,2362,2330,2348,2337,2370,2336,212,213,114.01720839208356,0
2124,2122,2121,2122,2124,2124,2123,2124,2362,2330,2348,2337,2370,2336,2352,228,228,116.51331417890567,0
2122,2121,2122,2124,2124,2123,2124,2362,2330,2348,2337,2370,2336,2352,2355,233,-7,117.05961037416954,0
2121,2122,2124,2124,2123,2124,2362,2330,2348,2337,2370,2336,2352,2355,2357,236,27,115.37454534812137,0
2122,2124,2124,2123,2124,2362,2330,2348,2337,2370,2336,2352,2355,2357,2347,225,-1,110.72905585041268,0
2124,2124,2123,2124,2362,2330,2348,2337,2370,2336,2352,2355,2357,2347,2328,204,-9,103.02856746692014,0
2124,2123,2124,2362,2330,2348,2337,2370,2336,2352,2355,2357,2347,2328,2361,237,-9,93.88123195977838,0
2123,2124,2362,2330,2348,2337,2370,2336,2352,2355,2357,2347,2328,2361,2347,224,11,80.04629612798786,0
2124,2362,2330,2348,2337,2370,2336,2352,2355,2357,2347,2328,2361,2347,2354,230,2,59.282455446864915,0
2362,2330,2348,2337,2370,2336,2352,2355,2357,2347,2328,2361,2347,2354,2327,-35,-28,13.2492587393732,0
2330,2348,2337,2370,2336,2352,2355,2357,2347,2328,2361,2347,2354,2327,2341,11,-16,12.694205652298892,0
2348,2337,2370,2336,2352,2355,2357,2347,2328,2361,2347,2354,2327,2341,2370,22,23,13.280849083584693,0
2337,2370,2336,2352,2355,2357,2347,2328,2361,2347,2354,2327,2341,2370,2341,4,13,13.428115493779673,0
2370,2336,2352,2355,2357,2347,2328,2361,2347,2354,2327,2341,2370,2341,2357,-13,-4,13.22803660340235,0
2336,2352,2355,2357,2347,2328,2361,2347,2354,2327,2341,2370,2341,2357,2360,24,13,12.345425217849883,0
2352,2355,2357,2347,2328,2361,2347,2354,2327,2341,2370,2341,2357,2360,2337,-15,-17,12.273471197590975,0
2355,2357,2347,2328,2361,2347,2354,2327,2341,2370,2341,2357,2360,2337,2330,-25,3,13.163079680176166,0
2357,2347,2328,2361,2347,2354,2327,2341,2370,2341,2357,2360,2337,2330,2346,-11,5,12.999267378623781,0
2347,2328,2361,2347,2354,2327,2341,2370,2341,2357,2360,2337,2330,2346,2353,6,-17,12.816284284344775,0
2328,2361,2347,2354,2327,2341,2370,2341,2357,2360,2337,2330,2346,2353,2349,21,8,12.831137721889483,0
2361,2347,2354,2327,2341,2370,2341,2357,2360,2337,2330,2346,2353,2349,2322,-39,-35,13.53126890188936,0
2347,2354,2327,2341,2370,2341,2357,2360,2337,2330,2346,2353,2349,2322,2353,6,-7,13.061393493804557,0
2354,2327,2341,2370,2341,2357,2360,2337,2330,2346,2353,2349,2322,2353,2339,-15,2,13.17175911164633,0
2327,2341,2370,2341,2357,2360,2337,2330,2346,2353,2349,2322,2353,2339,2328,1,-2,13.64272001925604,0
2341,2370,2341,2357,2360,2337,2330,2346,2353,2349,2322,2353,2339,2328,2359,18,13,13.371967836093676,0
2370,2341,2357,2360,2337,2330,2346,2353,2349,2322,2353,2339,2328,2359,2315,-55,-38,15.530921537678433,0
2341,2357,2360,2337,2330,2346,2353,2349,2322,2353,2339,2328,2359,2315,2326,-15,-23,14.367622330384782,0
2357,2360,2337,2330,2346,2353,2349,2322,2353,2339,2328,2359,2315,2326,2333,-24,11,14.515344918231813,0
2360,2337,2330,2346,2353,2349,2322,2353,2339,2328,2359,2315,2326,2333,2356,-4,3,14.436065946094871,0
2337,2330,2346,2353,2349,2322,2353,2339,2328,2359,2315,2326,2333,2356,2342,5,3,13.401492454200763,0
2330,2346,2353,2349,2322,2353,2339,2328,2359,2315,2326,2333,2356,2342,2336,6,8,13.415697983368304,0
2346,2353,2349,2322,2353,2339,2328,2359,2315,2326,2333,2356,2342,2336,2329,-17,-30,13.466713814156034,0
2353,2349,2322,2353,2339,2328,2359,2315,2326,2333,2356,2342,2336,2329,2341,-12,26,13.344162269197218,0
2349,2322,2353,2339,2328,2359,2315,2326,2333,2356,2342,2336,2329,2341,2356,7,30,13.593415773121647,0
2322,2353,2339,2328,2359,2315,2326,2333,2356,2342,2336,2329,2341,2356,2317,-5,-16,14.388487461459297,0
2353,2339,2328,2359,2315,2326,2333,2356,2342,2336,2329,2341,2356,2317,2340,-13,-16,13.804761083460612,0
2339,2328,2359,2315,2326,2333,2356,2342,2336,2329,2341,2356,2317,2340,2335,-4,-7,13.175735273600482,0
2328,2359,2315,2326,2333,2356,2342,2336,2329,2341,2356,2317,2340,2335,2330,2,-6,13.272958546286075,0
2359,2315,2326,2333,2356,2342,2336,2329,2341,2356,2317,2340,2335,2330,2321,-38,-8,13.698105534638549,0
2315,2326,2333,2356,2342,2336,2329,2341,2356,2317,2340,2335,2330,2321,2356,41,15,13.351654079801,0
2326,2333,2356,2342,2336,2329,2341,2356,2317,2340,2335,2330,2321,2356,2323,-3,-33,12.612163441165304,0
2333,2356,2342,2336,2329,2341,2356,2317,2340,2335,2330,2321,2356,2323,2342,9,25,12.374320568168965,0
2356,2342,2336,2329,2341,2356,2317,2340,2335,2330,2321,2356,2323,2342,2323,-33,-17,12.872266237739106,0
2342,2336,2329,2341,2356,2317,2340,2335,2330,2321,2356,2323,2342,2323,2329,-13,-6,11.787806452108931,0
2336,2329,2341,2356,2317,2340,2335,2330,2321,2356,2323,2342,2323,2329,2306,-30,-24,13.698105534638549,0
2329,2341,2356,2317,2340,2335,2330,2321,2356,2323,2342,2323,2329,2306,2320,-9,-1,14.00612111083681,0
2341,2356,2317,2340,2335,2330,2321,2356,2323,2342,2323,2329,2306,2320,2346,5,-10,14.494662400181596,0
2356,2317,2340,2335,2330,2321,2356,2323,2342,2323,2329,2306,2320,2346,2330,-26,7,14.30184803243473,0
2317,2340,2335,2330,2321,2356,2323,2342,2323,2329,2306,2320,2346,2330,2336,19,-6,12.708077671120762,0
2340,2335,2330,2321,2356,2323,2342,2323,2329,2306,2320,2346,2330,2336,2326,-14,3,12.240837195147039,0
2335,2330,2321,2356,2323,2342,2323,2329,2306,2320,2346,2330,2336,2326,2325,-10,-4,12.052662223204742,0
2330,2321,2356,2323,2342,2323,2329,2306,2320,2346,2330,2336,2326,2325,2331,1,25,11.974973903938164,0
2321,2356,2323,2342,2323,2329,2306,2320,2346,2330,2336,2326,2325,2331,2305,-16,-15,13.551313413765296,0
2356,2323,2342,2323,2329,2306,2320,2346,2330,2336,2326,2325,2331,2305,2334,-22,-12,13.491796449271366,0
2323,2342,2323,2329,2306,2320,2346,2330,2336,2326,2325,2331,2305,2334,2336,13,6,11.444691012908665,0
2342,2323,2329,2306,2320,2346,2330,2336,2326,2325,2331,2305,2334,2336,2324,-18,-12,11.41969893690389,0
2323,2329,2306,2320,2346,2330,2336,2326,2325,2331,2305,2334,2336,2324,2327,4,1,10.69623876928352,0
2329,2306,2320,2346,2330,2336,2326,2325,2331,2305,2334,2336,2324,2327,2330,1,5,10.683766056164705,0
2306,2320,2346,2330,2336,2326,2325,2331,2305,2334,2336,2324,2327,2330,2311,5,-20,11.428035701729321,0
2320,2346,2330,2336,2326,2325,2331,2305,2334,2336,2324,2327,2330,2311,2323,3,18,10.08865463681617,0
2346,2330,2336,2326,2325,2331,2305,2334,2336,2324,2327,2330,2311,2323,2289,-57,-45,14.019714011076722,0
2330,2336,2326,2325,2331,2305,2334,2336,2324,2327,2330,2311,2323,2289,2265,-65,-71,19.733462033042347,0
2336,2326,2325,2331,2305,2334,2336,2324,2327,2330,2311,2323,2289,2265,2224,-112,-100,31.288519117584144,0
2326,2325,2331,2305,2334,2336,2324,2327,2330,2311,2323,2289,2265,2224,2264,-62,-63,32.891162512574276,0
2325,2331,2305,2334,2336,2324,2327,2330,2311,2323,2289,2265,2224,2264,2259,-66,-71,34.712835556620156,0
2331,2305,2334,2336,2324,2327,2330,2311,2323,2289,2265,2224,2264,2259,2249,-82,-62,36.77822854948421,0
2305,2334,2336,2324,2327,2330,2311,2323,2289,2265,2224,2264,2259,2249,2321,16,-2,36.22508996340993,0
2334,2336,2324,2327,2330,2311,2323,2289,2265,2224,2264,2259,2249,2321,2330,-4,41,37.16270531953597,0
2336,2324,2327,2330,2311,2323,2289,2265,2224,2264,2259,2249,2321,2330,2317,-19,52,36.269756521036065,0
2324,2327,2330,2311,2323,2289,2265,2224,2264,2259,2249,2321,2330,2317,2326,2,102,35.60591176168576,0
2327,2330,2311,2323,2289,2265,2224,2264,2259,2249,2321,2330,2317,2326,2350,23,86,37.578489287661064,0
2330,2311,2323,2289,2265,2224,2264,2259,2249,2321,2330,2317,2326,2350,2343,13,84,38.64206935206141,0
2311,2323,2289,2265,2224,2264,2259,2249,2321,2330,2317,2326,2350,2343,2346,35,97,39.73279801493016,0
2323,2289,2265,2224,2264,2259,2249,2321,2330,2317,2326,2350,2343,2346,2341,18,20,40.99976771130481,0
2289,2265,2224,2264,2259,2249,2321,2330,2317,2326,2350,2343,2346,2341,2355,66,25,42.89599825935593,0
2265,2224,2264,2259,2249,2321,2330,2317,2326,2350,2343,2346,2341,2355,2355,90,38,44.46453910809419,0
2224,2264,2259,2249,2321,2330,2317,2326,2350,2343,2346,2341,2355,2355,2349,125,23,43.72065001912984,0
2264,2259,2249,2321,2330,2317,2326,2350,2343,2346,2341,2355,2355,2349,2342,78,-8,36.0730739841598,0
2259,2249,2321,2330,2317,2326,2350,2343,2346,2341,2355,2355,2349,2342,2348,89,5,32.589364318235276,0
2249,2321,2330,2317,2326,2350,2343,2346,2341,2355,2355,2349,2342,2348,2359,110,13,27.065528946297302,0
2321,2330,2317,2326,2350,2343,2346,2341,2355,2355,2349,2342,2348,2359,2351,30,10,12.929479052592512,0
2330,2317,2326,2350,2343,2346,2341,2355,2355,2349,2342,2348,2359,2351,2345,15,-10,11.527606615673276,0
2317,2326,2350,2343,2346,2341,2355,2355,2349,2342,2348,2359,2351,2345,2356,39,1,11.255897924876455,0
2326,2350,2343,2346,2341,2355,2355,2349,2342,2348,2359,2351,2345,2356,2355,29,6,8.250252521387855,0
2350,2343,2346,2341,2355,2355,2349,2342,2348,2359,2351,2345,2356,2355,2348,-2,6,5.566053573309583,0
2343,2346,2341,2355,2355,2349,2342,2348,2359,2351,2345,2356,2355,2348,2353,10,5,5.637459745395295,0
2346,2341,2355,2355,2349,2342,2348,2359,2351,2345,2356,2355,2348,2353,2354,8,-5,5.409867527644892,0
2341,2355,2355,2349,2342,2348,2359,2351,2345,2356,2355,2348,2353,2354,2340,-1,-11,5.957788020334233,0
2355,2355,2349,2342,2348,2359,2351,2345,2356,2355,2348,2353,2354,2340,2333,-22,-12,7.079817054402573,0
2355,2349,2342,2348,2359,2351,2345,2356,2355,2348,2353,2354,2340,2333,2349,-6,-7,6.916508890914204,0
2349,2342,2348,2359,2351,2345,2356,2355,2348,2353,2354,2340,2333,2349,2354,5,-1,6.860515043833566,0
2342,2348,2359,2351,2345,2356,2355,2348,2353,2354,2340,2333,2349,2354,2352,10,4,6.9020355865567105,0
2348,2359,2351,2345,2356,2355,2348,2353,2354,2340,2333,2349,2354,2352,2346,-2,-7,6.6747569957550485,0
2359,2351,2345,2356,2355,2348,2353,2354,2340,2333,2349,2354,2352,2346,2334,-25,-20,7.790103612001209,0
2351,2345,2356,2355,2348,2353,2354,2340,2333,2349,2354,2352,2346,2334,2337,-14,-3,7.7631608682718065,0
2345,2356,2355,2348,2353,2354,2340,2333,2349,2354,2352,2346,2334,2337,2346,1,13,7.692296703288854,0
2356,2355,2348,2353,2354,2340,2333,2349,2354,2352,2346,2334,2337,2346,2345,-11,-4,7.692296703288854,0
2355,2348,2353,2354,2340,2333,2349,2354,2352,2346,2334,2337,2346,2345,2355,0,1,7.610769312218675,0
2348,2353,2354,2340,2333,2349,2354,2352,2346,2334,2337,2346,2345,2355,2338,-10,-14,7.557399401532627,0
2353,2354,2340,2333,2349,2354,2352,2346,2334,2337,2346,2345,2355,2338,2341,-12,-5,7.614522465719855,0
2354,2340,2333,2349,2354,2352,2346,2334,2337,2346,2345,2355,2338,2341,2329,-25,-5,8.331237831770487,0
2340,2333,2349,2354,2352,2346,2334,2337,2346,2345,2355,2338,2341,2329,2338,-2,1,7.909006318898788,0
2333,2349,2354,2352,2346,2334,2337,2346,2345,2355,2338,2341,2329,2338,2341,8,-5,7.890923055426828,0
2349,2354,2352,2346,2334,2337,2346,2345,2355,2338,2341,2329,2338,2341,2328,-21,-17,8.410877311128557,0
2354,2352,2346,2334,2337,2346,2345,2355,2338,2341,2329,2338,2341,2328,2331,-23,-24,8.652002245558126,0
2352,2346,2334,2337,2346,2345,2355,2338,2341,2329,2338,2341,2328,2331,2332,-20,-6,8.140434058861153,2
2346,2334,2337,2346,2345,2355,2338,2341,2329,2338,2341,2328,2331,2332,2124,-222,-217,55.90893956971035,2
2334,2337,2346,2345,2355,2338,2341,2329,2338,2341,2328,2331,2332,2124,2123,-211,-206,75.83428047550854,2
2337,2346,2345,2355,2338,2341,2329,2338,2341,2328,2331,2332,2124,2123,2122,-215,-216,89.46560924788496,2
2346,2345,2355,2338,2341,2329,2338,2341,2328,2331,2332,2124,2123,2122,2121,-225,-220,99.14020855526255,2
2345,2355,2338,2341,2329,2338,2341,2328,2331,2332,2124,2123,2122,2121,2122,-223,-206,105.31720792783241,2
2355,2338,2341,2329,2338,2341,2328,2331,2332,2124,2123,2122,2121,2122,2123,-232,-208,108.95818332867759,2
2338,2341,2329,2338,2341,2328,2331,2332,2124,2123,2122,2121,2122,2123,2126,-212,-206,109.4175923871912,2
2341,2329,2338,2341,2328,2331,2332,2124,2123,2122,2121,2122,2123,2126,2130,-211,6,108.73655362957801,2
2329,2338,2341,2328,2331,2332,2124,2123,2122,2121,2122,2123,2126,2130,2134,-195,11,105.65609080317861,2
2338,2341,2328,2331,2332,2124,2123,2122,2121,2122,2123,2126,2130,2134,2134,-204,12,101.66082731083694,2
2341,2328,2331,2332,2124,2123,2122,2121,2122,2123,2126,2130,2134,2134,2136,-205,15,94.53208072244198,2
2328,2331,2332,2124,2123,2122,2121,2122,2123,2126,2130,2134,2134,2136,2130,-198,8,84.2949470326549,2
2331,2332,2124,2123,2122,2121,2122,2123,2126,2130,2134,2134,2136,2130,2132,-199,9,71.96692361938292,2
2332,2124,2123,2122,2121,2122,2123,2126,2130,2134,2134,2136,2130,2132,2128,-204,2,53.036196085674305,2
2124,2123,2122,2121,2122,2123,2126,2130,2134,2134,2136,2130,2132,2128,2125,1,-5,5.023753102820166,0
2123,2122,2121,2122,2123,2126,2130,2134,2134,2136,2130,2132,2128,2125,2128,5,-6,4.9396356140913875,0
2122,2121,2122,2123,2126,2130,2134,2134,2136,2130,2132,2128,2125,2128,2129,7,-5,4.780914437337574,0
2121,2122,2123,2126,2130,2134,2134,2136,2130,2132,2128,2125,2128,2129,2133,12,-3,4.636295729916082,0
2122,2123,2126,2130,2134,2134,2136,2130,2132,2128,2125,2128,2129,2133,2136,14,6,4.463609472591607,0
2123,2126,2130,2134,2134,2136,2130,2132,2128,2125,2128,2129,2133,2136,2135,12,3,4.102264183176338,0
2126,2130,2134,2134,2136,2130,2132,2128,2125,2128,2129,2133,2136,2135,2135,9,7,3.6606010435446255,0
2130,2134,2134,2136,2130,2132,2128,2125,2128,2129,2133,2136,2135,2135,2135,5,10,3.4434202266268428,0
2134,2134,2136,2130,2132,2128,2125,2128,2129,2133,2136,2135,2135,2135,2134,0,6,3.432339199576927,0
2134,2136,2130,2132,2128,2125,2128,2129,2133,2136,2135,2135,2135,2134,2129,-5,0,3.494212902718409,0
2136,2130,2132,2128,2125,2128,2129,2133,2136,2135,2135,2135,2134,2129,2129,-7,-4,3.521363372331802,0
2130,2132,2128,2125,2128,2129,2133,2136,2135,2135,2135,2134,2129,2129,2130,0,-6,3.320929301953209,0
2132,2128,2125,2128,2129,2133,2136,2135,2135,2135,2134,2129,2129,2130,2132,0,-3,3.3094381626464866,0
2128,2125,2128,2129,2133,2136,2135,2135,2135,2134,2129,2129,2130,2132,2133,5,-2,3.3338094898007764,0
2125,2128,2129,2133,2136,2135,2135,2135,2134,2129,2129,2130,2132,2133,2139,14,4,3.7199590371528606,0
2128,2129,2133,2136,2135,2135,2135,2134,2129,2129,2130,2132,2133,2139,2138,10,4,3.4434202266268428,0
2129,2133,2136,2135,2135,2135,2134,2129,2129,2130,2132,2133,2139,2138,2138,9,9,3.373566715058764,0
2133,2136,2135,2135,2135,2134,2129,2129,2130,2132,2133,2139,2138,2138,2138,5,9,3.283436063174123,0
2136,2135,2135,2135,2134,2129,2129,2130,2132,2133,2139,2138,2138,2138,2133,-3,3,3.283436063174123,0
2135,2135,2135,2134,2129,2129,2130,2132,2133,2139,2138,2138,2138,2133,2133,-2,1,3.2616093018777157,0
2135,2135,2134,2129,2129,2130,2132,2133,2139,2138,2138,2138,2133,2133,2129,-6,-4,3.498298906339371,0
2135,2134,2129,2129,2130,2132,2133,2139,2138,2138,2138,2133,2133,2129,2132,-3,-7,3.5023801430836525,0
2134,2129,2129,2130,2132,2133,2139,2138,2138,2138,2133,2133,2129,2132,2132,-2,-6,3.494212902718409,0
2129,2129,2130,2132,2133,2139,2138,2138,2138,2133,2133,2129,2132,2132,2138,9,0,3.700707783010987,0
2129,2130,2132,2133,2139,2138,2138,2138,2133,2133,2129,2132,2132,2138,2140,11,2,3.8259763770958175,0
2130,2132,2133,2139,2138,2138,2138,2133,2133,2129,2132,2132,2138,2140,2141,11,8,3.899938949461108,0
2132,2133,2139,2138,2138,2138,2133,2133,2129,2132,2132,2138,2140,2141,2142,10,9,4.015446366695678,0
2133,2139,2138,2138,2138,2133,2133,2129,2132,2132,2138,2140,2141,2142,2139,6,10,3.94002658922621,0
2139,2138,2138,2138,2133,2133,2129,2132,2132,2138,2140,2141,2142,2139,2135,-4,3,3.8520248231411016,0
2138,2138,2138,2133,2133,2129,2132,2132,2138,2140,2141,2142,2139,2135,2135,-3,3,3.80225497003329,0
2138,2138,2133,2133,2129,2132,2132,2138,2140,2141,2142,2139,2135,2135,2131,-7,-7,3.990464825532174,0
2138,2133,2133,2129,2132,2132,2138,2140,2141,2142,2139,2135,2135,2131,2132,-6,-8,4.047338925881101,0
2133,2133,2129,2132,2132,2138,2140,2141,2142,2139,2135,2135,2131,2132,2131,-2,-10,4.120795115138871,0
2133,2129,2132,2132,2138,2140,2141,2142,2139,2135,2135,2131,2132,2131,2136,3,-6,4.0964560757992245,0
2129,2132,2132,2138,2140,2141,2142,2139,2135,2135,2131,2132,2131,2136,2139,10,0,4.172472146045292,0
2132,2132,2138,2140,2141,2142,2139,2135,2135,2131,2132,2131,2136,2139,2140,8,5,3.913347124174613,0
2132,2138,2140,2141,2142,2139,2135,2135,2131,2132,2131,2136,2139,2140,2141,9,6,3.913347124174613,0
2138,2140,2141,2142,2139,2135,2135,2131,2132,2131,2136,2139,2140,2141,2138,0,7,3.687817782917155,0
2140,2141,2142,2139,2135,2135,2131,2132,2131,2136,2139,2140,2141,2138,2135,-5,3,3.722518348798681,0
2141,2142,2139,2135,2135,2131,2132,2131,2136,2139,2140,2141,2138,2135,2134,-7,3,3.6994208040873486,0
2142,2139,2135,2135,2131,2132,2131,2136,2139,2140,2141,2138,2135,2134,2132,-10,-4,3.6645015252516173,0
2139,2135,2135,2131,2132,2131,2136,2139,2140,2141,2138,2135,2134,2132,2134,-5,-5,3.2921262488086995,0
2135,2135,2131,2132,2131,2136,2139,2140,2141,2138,2135,2134,2132,2134,2135,0,-5,3.1441555759399513,0
2135,2131,2132,2131,2136,2139,2140,2141,2138,2135,2134,2132,2134,2135,2137,2,-4,3.1773004414499577,0
2131,2132,2131,2136,2139,2140,2141,2138,2135,2134,2132,2134,2135,2137,2141,10,3,3.494212902718409,0
2132,2131,2136,2139,2140,2141,2138,2135,2134,2132,2134,2135,2137,2141,2143,11,8,3.700707783010987,0
2131,2136,2139,2140,2141,2138,2135,2134,2132,2134,2135,2137,2141,2143,2142,11,8,3.7263540204487127,0
2136,2139,2140,2141,2138,2135,2134,2132,2134,2135,2137,2141,2143,2142,2142,6,10,3.494212902718409,0
2139,2140,2141,2138,2135,2134,2132,2134,2135,2137,2141,2143,2142,2142,2139,0,5,3.461351236287988,0
2140,2141,2138,2135,2134,2132,2134,2135,2137,2141,2143,2142,2142,2139,2140,0,5,3.4887574537976374,0
2141,2138,2135,2134,2132,2134,2135,2137,2141,2143,2142,2142,2139,2140,2138,-3,1,3.453086955726647,0
2138,2135,2134,2132,2134,2135,2137,2141,2143,2142,2142,2139,2140,2138,2139,1,-2,3.369329451445933,0
2135,2134,2132,2134,2135,2137,2141,2143,2142,2142,2139,2140,2138,2139,2138,3,-5,3.369329451445933,0
2134,2132,2134,2135,2137,2141,2143,2142,2142,2139,2140,2138,2139,2138,2142,8,0,3.418437404094784,0
2132,2134,2135,2137,2141,2143,2142,2142,2139,2140,2138,2139,2138,2142,2145,13,3,3.58302877997027,0
2134,2135,2137,2141,2143,2142,2142,2139,2140,2138,2139,2138,2142,2145,2145,11,6,3.295017884191656,0
2135,2137,2141,2143,2142,2142,2139,2140,2138,2139,2138,2142,2145,2145,2145,10,5,3.081434421700078,0
2137,2141,2143,2142,2142,2139,2140,2138,2139,2138,2142,2145,2145,2145,2146,9,8,2.9244454093692624,0
2141,2143,2142,2142,2139,2140,2138,2139,2138,2142,2145,2145,2145,2146,2143,2,4,2.6690465570704314,0
2143,2142,2142,2139,2140,2138,2139,2138,2142,2145,2145,2145,2146,2143,2139,-4,1,2.7637104114026196,0
2142,2142,2139,2140,2138,2139,2138,2142,2145,2145,2145,2146,2143,2139,2144,2,2,2.808151400069855,0
2142,2139,2140,2138,2139,2138,2142,2145,2145,2145,2146,2143,2139,2144,2143,1,-2,2.8250579429371676,0
2139,2140,2138,2139,2138,2142,2145,2145,2145,2146,2143,2139,2144,2143,2143,4,-2,2.840187787218772,0
2140,2138,2139,2138,2142,2145,2145,2145,2146,2143,2139,2144,2143,2143,2144,4,-1,2.76371041140262,0
2138,2139,2138,2142,2145,2145,2145,2146,2143,2139,2144,2143,2143,2144,2149,11,3,3.1817934445544265,0
2139,2138,2142,2145,2145,2145,2146,2143,2139,2144,2143,2143,2144,2149,2152,13,9,3.6683978597124463,0
2138,2142,2145,2145,2145,2146,2143,2139,2144,2143,2143,2144,2149,2152,2149,11,10,3.6423435679060625,0
2142,2145,2145,2145,2146,2143,2139,2144,2143,2143,2144,2149,2152,2149,2149,7,5,3.3423687066852112,0
2145,2145,2145,2146,2143,2139,2144,2143,2143,2144,2149,2152,2149,2149,2146,1,3,3.2263793654069586,0
2145,2145,2146,2143,2139,2144,2143,2143,2144,2149,2152,2149,2149,2146,2148,3,5,3.2877840272018797,0
2145,2146,2143,2139,2144,2143,2143,2144,2149,2152,2149,2149,2146,2148,2145,0,1,3.2877840272018797,0
2146,2143,2139,2144,2143,2143,2144,2149,2152,2149,2149,2146,2148,2145,2146,0,-3,3.2834360631741224,0
2143,2139,2144,2143,2143,2144,2149,2152,2149,2149,2146,2148,2145,2146,2147,4,-5,3.299350585450762,0
2139,2144,2143,2143,2144,2149,2152,2149,2149,2146,2148,2145,2146,2147,2146,7,-3,3.2071349029490928,0
2144,2143,2143,2144,2149,2152,2149,2149,2146,2148,2145,2146,2147,2146,2148,4,-1,2.585674822114004,0
2143,2143,2144,2149,2152,2149,2149,2146,2148,2145,2146,2147,2146,2148,2152,9,6,2.8250579429371676,0
2143,2144,2149,2152,2149,2149,2146,2148,2145,2146,2147,2146,2148,2152,2149,6,1,2.614975188810639,0
2144,2149,2152,2149,2149,2146,2148,2145,2146,2147,2146,2148,2152,2149,2147,3,2,2.305273457593635,0
2149,2152,2149,2149,2146,2148,2145,2146,2147,2146,2148,2152,2149,2147,2145,-4,-1,2.1995670569671746,0
2152,2149,2149,2146,2148,2145,2146,2147,2146,2148,2152,2149,2147,2145,2148,-4,1,2.177810171446801,0
2149,2149,2146,2148,2145,2146,2147,2146,2148,2152,2149,2147,2145,2148,2145,-4,-1,1.9518001458970664,0
2149,2146,2148,2145,2146,2147,2146,2148,2152,2149,2147,2145,2148,2145,2149,0,1,1.9518001458970664,0
2146,2148,2145,2146,2147,2146,2148,2152,2149,2147,2145,2148,2145,2149,2145,-1,-7,1.98086080374405,0
2148,2145,2146,2147,2146,2148,2152,2149,2147,2145,2148,2145,2149,2145,2146,-2,-3,1.98086080374405,0
2145,2146,2147,2146,2148,2152,2149,2147,2145,2148,2145,2149,2145,2146,2145,0,-2,2.0307165050320353,0
2146,2147,2146,2148,2152,2149,2147,2145,2148,2145,2149,2145,2146,2145,2146,0,1,1.98086080374405,0
2147,2146,2148,2152,2149,2147,2145,2148,2145,2149,2145,2146,2145,2146,2141,-6,-7,2.501428163498376,0
2146,2148,2152,2149,2147,2145,2148,2145,2149,2145,2146,2145,2146,2141,2141,-5,-4,2.8834503141697647,0
2148,2152,2149,2147,2145,2148,2145,2149,2145,2146,2145,2146,2141,2141,2131,-17,-18,4.872664275615255,0
2152,2149,2147,2145,2148,2145,2149,2145,2146,2145,2146,2141,2141,2131,2126,-26,-19,6.870918702002215,0
2149,2147,2145,2148,2145,2149,2145,2146,2145,2146,2141,2141,2131,2126,2119,-30,-27,8.991000791797052,0
2147,2145,2148,2145,2149,2145,2146,2145,2146,2141,2141,2131,2126,2119,2125,-22,-20,9.676677902983814,0
2145,2148,2145,2149,2145,2146,2145,2146,2141,2141,2131,2126,2119,2125,2122,-23,-24,10.49126620893144,0
2148,2145,2149,2145,2146,2145,2146,2141,2141,2131,2126,2119,2125,2122,2117,-31,-24,11.636150566231086,0
2145,2149,2145,2146,2145,2146,2141,2141,2131,2126,2119,2125,2122,2117,2118,-27,-23,12.070033731755446,0
2149,2145,2146,2145,2146,2141,2141,2131,2126,2119,2125,2122,2117,2118,2109,-40,-22,13.32559299136172,0
2145,2146,2145,2146,2141,2141,2131,2126,2119,2125,2122,2117,2118,2109,2106,-39,-20,14.014618218471876,0
2146,2145,2146,2141,2141,2131,2126,2119,2125,2122,2117,2118,2109,2106,2109,-37,-10,14.184834289110459,0
2145,2146,2141,2141,2131,2126,2119,2125,2122,2117,2118,2109,2106,2109,2111,-34,-14,13.65806930509789,0
2146,2141,2141,2131,2126,2119,2125,2122,2117,2118,2109,2106,2109,2111,2101,-45,-21,13.64272001925604,0
2141,2141,2131,2126,2119,2125,2122,2117,2118,2109,2106,2109,2111,2101,2091,-50,-26,13.965263027547008,0
2141,2131,2126,2119,2125,2122,2117,2118,2109,2106,2109,2111,2101,2091,2072,-69,-46,16.844668507953998,0
2131,2126,2119,2125,2122,2117,2118,2109,2106,2109,2111,2101,2091,2072,2135,4,26,16.196119464683065,0
2126,2119,2125,2122,2117,2118,2109,2106,2109,2111,2101,2091,2072,2135,2135,9,29,16.546327459014957,0
2119,2125,2122,2117,2118,2109,2106,2109,2111,2101,2091,2072,2135,2135,2133,14,24,17.028827099390973,0
2125,2122,2117,2118,2109,2106,2109,2111,2101,2091,2072,2135,2135,2133,2131,6,20,17.577041302573676,0
2122,2117,2118,2109,2106,2109,2111,2101,2091,2072,2135,2135,2133,2131,2091,-31,-10,18.281398300171784,0
2117,2118,2109,2106,2109,2111,2101,2091,2072,2135,2135,2133,2131,2091,2051,-66,-40,23.86469797679848,0
2118,2109,2106,2109,2111,2101,2091,2072,2135,2135,2133,2131,2091,2051,2102,-16,30,23.744673588186547,0
2109,2106,2109,2111,2101,2091,2072,2135,2135,2133,2131,2091,2051,2102,2107,-2,-28,23.527491518282545,0
2106,2109,2111,2101,2091,2072,2135,2135,2133,2131,2091,2051,2102,2107,2047,-59,-88,27.92302344115404,0
2109,2111,2101,2091,2072,2135,2135,2133,2131,2091,2051,2102,2107,2047,2027,-82,-106,33.831937573836946,0
2111,2101,2091,2072,2135,2135,2133,2131,2091,2051,2102,2107,2047,2027,2050,-61,-81,35.61995160553917,0
2101,2091,2072,2135,2135,2133,2131,2091,2051,2102,2107,2047,2027,2050,2008,-93,-83,41.235906683374864,0
2091,2072,2135,2135,2133,2131,2091,2051,2102,2107,2047,2027,2050,2008,2002,-89,-49,46.18626883145497,0
2072,2135,2135,2133,2131,2091,2051,2102,2107,2047,2027,2050,2008,2002,2002,-70,-100,50.061200640054665,0
2135,2135,2133,2131,2091,2051,2102,2107,2047,2027,2050,2008,2002,2002,2002,-133,-105,53.305320023963304,0
2135,2133,2131,2091,2051,2102,2107,2047,2027,2050,2008,2002,2002,2002,2003,-132,-44,52.37747607512221,0
2133,2131,2091,2051,2102,2107,2047,2027,2050,2008,2002,2002,2002,2003,2003,-130,-24,49.79357388258047,0
2131,2091,2051,2102,2107,2047,2027,2050,2008,2002,2002,2002,2003,2003,2004,-127,-46,45.50039246298557,0
2091,2051,2102,2107,2047,2027,2050,2008,2002,2002,2002,2003,2003,2004,2004,-87,-4,39.125926126266904,0
2051,2102,2107,2047,2027,2050,2008,2002,2002,2002,2003,2003,2004,2004,2002,-49,0,36.44526228273221,0
2102,2107,2047,2027,2050,2008,2002,2002,2002,2003,2003,2004,2004,2002,2002,-100,0,36.39400787937225,0
2107,2047,2027,2050,2008,2002,2002,2002,2003,2003,2004,2004,2002,2002,2003,-104,1,29.65628496786538,0
2047,2027,2050,2008,2002,2002,2002,2003,2003,2004,2004,2002,2002,2003,2002,-45,-1,16.598049225593897,0
2027,2050,2008,2002,2002,2002,2003,2003,2004,2004,2002,2002,2003,2002,2007,-20,4,13.225876512496612,0
2050,2008,2002,2002,2002,2003,2003,2004,2004,2002,2002,2003,2002,2007,2005,-45,1,12.152601132503044,1
2008,2002,2002,2002,2003,2003,2004,2004,2002,2002,2003,2002,2007,2005,2005,-3,1,1.9198214202665531,1
2002,2002,2002,2003,2003,2004,2004,2002,2002,2003,2002,2007,2005,2005,2003,1,1,1.486446705914413,1
2002,2002,2003,2003,2004,2004,2002,2002,2003,2002,2007,2005,2005,2003,2002,0,0,1.486446705914413,1
2002,2003,2003,2004,2004,2002,2002,2003,2002,2007,2005,2005,2003,2002,2004,2,1,1.4540583599999397,1
2003,2003,2004,2004,2002,2002,2003,2002,2007,2005,2005,2003,2002,2004,2001,-2,-1,1.5430334996209192,1
2003,2004,2004,2002,2002,2003,2002,2007,2005,2005,2003,2002,2004,2001,2003,0,-4,1.5430334996209192,1
2004,2004,2002,2002,2003,2002,2007,2005,2005,2003,2002,2004,2001,2003,2002,-2,-3,1.5796322658258457,1
2004,2002,2002,2003,2002,2007,2005,2005,2003,2002,2004,2001,2003,2002,2003,-1,-2,1.5675276256394517,1
2002,2002,2003,2002,2007,2005,2005,2003,2002,2004,2001,2003,2002,2003,2006,4,3,1.7182493859684491,1
2002,2003,2002,2007,2005,2005,2003,2002,2004,2001,2003,2002,2003,2006,2006,4,4,1.804755622554715,1
2003,2002,2007,2005,2005,2003,2002,2004,2001,2003,2002,2003,2006,2006,2006,3,2,1.8464895909600492,1
2002,2007,2005,2005,2003,2002,2004,2001,2003,2002,2003,2006,2006,2006,2005,3,4,1.8516401995451028,1
2007,2005,2005,2003,2002,2004,2001,2003,2002,2003,2006,2006,2006,2005,2002,-5,-1,1.8516401995451028,1
2005,2005,2003,2002,2004,2001,2003,2002,2003,2006,2006,2006,2005,2002,2001,-4,-1,1.804755622554715,1
2005,2003,2002,2004,2001,2003,2002,2003,2006,2006,2006,2005,2002,2001,2001,-4,-2,1.877181270897812,0
2003,2002,2004,2001,2003,2002,2003,2006,2006,2006,2005,2002,2001,2001,2004,1,-2,1.8309508328682538,0
2002,2004,2001,2003,2002,2003,2006,2006,2006,2005,2002,2001,2001,2004,2002,0,-4,1.8593393604027364,0
2004,2001,2003,2002,2003,2006,2006,2006,2005,2002,2001,2001,2004,2002,2003,-1,-3,1.8309508328682538,0
2001,2003,2002,2003,2006,2006,2006,2005,2002,2001,2001,2004,2002,2003,2004,3,-1,1.8309508328682538,0
2003,2002,2003,2006,2006,2006,2005,2002,2001,2001,2004,2002,2003,2004,2005,2,3,1.7674302033770737,0
2002,2003,2006,2006,2006,2005,2002,2001,2001,2004,2002,2003,2004,2005,2234,232,233,59.52246474671399,0
2003,2006,2006,2006,2005,2002,2001,2001,2004,2002,2003,2004,2005,2234,2239,236,238,81.9402802277947,0
2006,2006,2006,2005,2002,2001,2001,2004,2002,2003,2004,2005,2234,2239,2221,215,217,94.3091168647524,0
2006,2006,2005,2002,2001,2001,2004,2002,2003,2004,2005,2234,2239,2221,2235,229,233,104.76086146666653,0
2006,2005,2002,2001,2001,2004,2002,2003,2004,2005,2234,2239,2221,2235,2232,226,229,111.7591798722337,0
2005,2002,2001,2001,2004,2002,2003,2004,2005,2234,2239,2221,2235,2232,2230,225,226,116.10332016088495,0
2002,2001,2001,2004,2002,2003,2004,2005,2234,2239,2221,2235,2232,2230,2215,213,210,117.19206864110281,0
2001,2001,2004,2002,2003,2004,2005,2234,2239,2221,2235,2232,2230,2215,2227,226,-7,116.98160213510172,0
2001,2004,2002,2003,2004,2005,2234,2239,2221,2235,2232,2230,2215,2227,2234,233,-5,115.00153208089178,0
2004,2002,2003,2004,2005,2234,2239,2221,2235,2232,2230,2215,2227,2234,2217,213,-4,109.88816826123512,0
2002,2003,2004,2005,2234,2239,2221,2235,2232,2230,2215,2227,2234,2217,2226,224,-9,103.05717322137723,0
2003,2004,2005,2234,2239,2221,2235,2232,2230,2215,2227,2234,2217,2226,2239,236,7,93.46692819744675,0
2004,2005,2234,2239,2221,2235,2232,2230,2215,2227,2234,2217,2226,2239,2224,220,-6,79.21868466466734,0
2005,2234,2239,2221,2235,2232,2230,2215,2227,2234,2217,2226,2239,2224,2225,220,10,58.15111676444727,0
2234,2239,2221,2235,2232,2230,2215,2227,2234,2217,2226,2239,2224,2225,2215,-19,-12,8.096442487437365,0
2239,2221,2235,2232,2230,2215,2227,2234,2217,2226,2239,2224,2225,2215,2221,-18,-13,8.050436249640377,0
2221,2235,2232,2230,2215,2227,2234,2217,2226,2239,2224,2225,2215,2221,2216,-5,-1,7.717018916160629,0
2235,2232,2230,2215,2227,2234,2217,2226,2239,2224,2225,2215,2221,2216,2214,-21,-12,8.18244345855081,0
2232,2230,2215,2227,2234,2217,2226,2239,2224,2225,2215,2221,2216,2214,2225,-7,-14,7.671840904055744,0
2230,2215,2227,2234,2217,2226,2239,2224,2225,2215,2221,2216,2214,2225,2213,-17,-11,7.823651564935891,0
2215,2227,2234,2217,2226,2239,2224,2225,2215,2221,2216,2214,2225,2213,2223,8,-2,7.5636977603235716,0
2227,2234,2217,2226,2239,2224,2225,2215,2221,2216,2214,2225,2213,2223,2224,-3,9,7.2984016515033385,0
2234,2217,2226,2239,2224,2225,2215,2221,2216,2214,2225,2213,2223,2224,2218,-16,-3,7.304271418312777,0
2217,2226,2239,2224,2225,2215,2221,2216,2214,2225,2213,2223,2224,2218,2231,14,15,6.9945557059622825,0
2226,2239,2224,2225,2215,2221,2216,2214,2225,2213,2223,2224,2218,2231,2210,-16,-4,7.566844973774926,0
2239,2224,2225,2215,2221,2216,2214,2225,2213,2223,2224,2218,2231,2210,2236,-3,11,8.379112352124407,0
2224,2225,2215,2221,2216,2214,2225,2213,2223,2224,2218,2231,2210,2236,2220,-4,7,6.98978847012861,0
2225,2215,2221,2216,2214,2225,2213,2223,2224,2218,2231,2210,2236,2220,2234,9,11,7.733661733585444,0
2215,2221,2216,2214,2225,2213,2223,2224,2218,2231,2210,2236,2220,2234,2226,11,2,7.768679485754381,0
2221,2216,2214,2225,2213,2223,2224,2218,2231,2210,2236,2220,2234,2226,2225,4,7,7.576278769950324,0
2216,2214,2225,2213,2223,2224,2218,2231,2210,2236,2220,2234,2226,2225,2242,26,11,9.08845421400141,0
2214,2225,2213,2223,2224,2218,2231,2210,2236,2220,2234,2226,2225,2242,2240,26,30,9.708611788363095,0
2225,2213,2223,2224,2218,2231,2210,2236,2220,2234,2226,2225,2242,2240,2208,-17,-28,10.316422414217607,0
2213,2223,2224,2218,2231,2210,2236,2220,2234,2226,2225,2242,2240,2208,2218,5,-2,10.473549450651298,0
2223,2224,2218,2231,2210,2236,2220,2234,2226,2225,2242,2240,2208,2218,2227,4,-7,9.984750277059417,0
2224,2218,2231,2210,2236,2220,2234,2226,2225,2242,2240,2208,2218,2227,2203,-21,-23,11.550304057016154,0
2218,2231,2210,2236,2220,2234,2226,2225,2242,2240,2208,2218,2227,2203,2207,-11,-18,12.36931687685298,0
2231,2210,2236,2220,2234,2226,2225,2242,2240,2208,2218,2227,2203,2207,2225,-6,-17,12.299051453940123,0
2210,2236,2220,2234,2226,2225,2242,2240,2208,2218,2227,2203,2207,2225,2230,20,-10,12.257942031888668,0
2236,2220,2234,2226,2225,2242,2240,2208,2218,2227,2203,2207,2225,2230,2221,-15,13,11.716085808266627,0
2220,2234,2226,2225,2242,2240,2208,2218,2227,2203,2207,2225,2230,2221,2214,-6,-4,11.499482390007614,0
2234,2226,2225,2242,2240,2208,2218,2227,2203,2207,2225,2230,2221,2214,2223,-11,-4,11.475854569278843,0
2226,2225,2242,2240,2208,2218,2227,2203,2207,2225,2230,2221,2214,2223,2211,-15,8,11.4184478971948,0
2225,2242,2240,2208,2218,2227,2203,2207,2225,2230,2221,2214,2223,2211,2207,-18,0,11.907180706655643,0
2242,2240,2208,2218,2227,2203,2207,2225,2230,2221,2214,2223,2211,2207,2229,-13,4,12.069244660154448,0
2240,2208,2218,2227,2203,2207,2225,2230,2221,2214,2223,2211,2207,2229,2217,-23,-13,10.485818086939185,0
2208,2218,2227,2203,2207,2225,2230,2221,2214,2223,2211,2207,2229,2217,2219,11,-2,8.68057492061332,0
2218,2227,2203,2207,2225,2230,2221,2214,2223,2211,2207,2229,2217,2219,2232,14,18,9.054333348234556,0
2227,2203,2207,2225,2230,2221,2214,2223,2211,2207,2229,2217,2219,2232,2215,-12,-8,9.10781976942786,0
2203,2207,2225,2230,2221,2214,2223,2211,2207,2229,2217,2219,2232,2215,2219,16,8,8.814490234564794,0
2207,2225,2230,2221,2214,2223,2211,2207,2229,2217,2219,2232,2215,2219,2212,5,5,7.977348885318683,0
2225,2230,2221,2214,2223,2211,2207,2229,2217,2219,2232,2215,2219,2212,2231,6,2,7.861903319777204,0
2230,2221,2214,2223,2211,2207,2229,2217,2219,2232,2215,2219,2212,2231,2210,-20,-7,8.173709305420875,0
2221,2214,2223,2211,2207,2229,2217,2219,2232,2215,2219,2212,2231,2210,2231,10,12,8.270429251254134,0
2214,2223,2211,2207,2229,2217,2219,2232,2215,2219,2212,2231,2210,2231,2216,2,-16,8.302036468470222,0
2223,2211,2207,2229,2217,2219,2232,2215,2219,2212,2231,2210,2231,2216,2226,3,11,8.356919003920957,0
2211,2207,2229,2217,2219,2232,2215,2219,2212,2231,2210,2231,2216,2226,2218,7,-1,8.32265983124786,0
2207,2229,2217,2219,2232,2215,2219,2212,2231,2210,2231,2216,2226,2218,2224,17,12,8.042742957829393,0
2229,2217,2219,2232,2215,2219,2212,2231,2210,2231,2216,2226,2218,2224,2222,-7,-9,7.13942774817622,0
2217,2219,2232,2215,2219,2212,2231,2210,2231,2216,2226,2218,2224,2222,2225,8,15,6.906173911453294,0
2219,2232,2215,2219,2212,2231,2210,2231,2216,2226,2218,2224,2222,2225,2214,-5,-17,7.075780286771676,0
2232,2215,2219,2212,2231,2210,2231,2216,2226,2218,2224,2222,2225,2214,2208,-24,-8,7.8212165659460275,0
2215,2219,2212,2231,2210,2231,2216,2226,2218,2224,2222,2225,2214,2208,2234,19,8,8.050436249640377,0
2219,2212,2231,2210,2231,2216,2226,2218,2224,2222,2225,2214,2208,2234,2215,-4,-3,8.050436249640377,0
2212,2231,2210,2231,2216,2226,2218,2224,2222,2225,2214,2208,2234,2215,2222,10,-2,8.052210580834013,0
2231,2210,2231,2216,2226,2218,2224,2222,2225,2214,2208,2234,2215,2222,2203,-28,-19,9.011632693886487,0
2210,2231,2216,2226,2218,2224,2222,2225,2214,2208,2234,2215,2222,2203,2223,13,-2,8.533965750374877,0
2231,2216,2226,2218,2224,2222,2225,2214,2208,2234,2215,2222,2203,2223,2219,-12,5,8.132825901423018,0
2216,2226,2218,2224,2222,2225,2214,2208,2234,2215,2222,2203,2223,2219,2244,28,36,9.891314130998733,0
2226,2218,2224,2222,2225,2214,2208,2234,2215,2222,2203,2223,2219,2244,2226,0,-8,9.876860885543593,0
2218,2224,2222,2225,2214,2208,2234,2215,2222,2203,2223,2219,2244,2226,2219,1,4,9.815924864850023,0
2224,2222,2225,2214,2208,2234,2215,2222,2203,2223,2219,2244,2226,2219,2229,5,7,9.979979959899719,0
2222,2225,2214,2208,2234,2215,2222,2203,2223,2219,2244,2226,2219,2229,2230,8,27,10.192434168819256,0
2225,2214,2208,2234,2215,2222,2203,2223,2219,2244,2226,2219,2229,2230,2211,-14,-12,10.595596569644707,0
2214,2208,2234,2215,2222,2203,2223,2219,2244,2226,2219,2229,2230,2211,2191,-23,-28,13.121411073944317,0
2208,2234,2215,2222,2203,2223,2219,2244,2226,2219,2229,2230,2211,2191,2204,-4,-40,13.647954669717608,0
2234,2215,2222,2203,2223,2219,2244,2226,2219,2229,2230,2211,2191,2204,2238,4,12,14.181812631811546,0
2215,2222,2203,2223,2219,2244,2226,2219,2229,2230,2211,2191,2204,2238,2215,0,-4,13.734558428944675,0
2222,2203,2223,2219,2244,2226,2219,2229,2230,2211,2191,2204,2238,2215,2215,-7,-14,13.734558428944675,0
2203,2223,2219,2244,2226,2219,2229,2230,2211,2191,2204,2238,2215,2215,2222,19,-8,13.734558428944675,0
2223,2219,2244,2226,2219,2229,2230,2211,2191,2204,2238,2215,2215,2222,2203,-20,-8,13.734558428944675,0
2219,2244,2226,2219,2229,2230,2211,2191,2204,2238,2215,2215,2222,2203,2223,4,32,13.734558428944675,0
2244,2226,2219,2229,2230,2211,2191,2204,2238,2215,2215,2222,2203,2223,2215,-29,11,13.778865804453677,0
2226,2219,2229,2230,2211,2191,2204,2238,2215,2215,2222,2203,2223,2215,2215,-11,-23,11.931151702680715,0
2219,2229,2230,2211,2191,2204,2238,2215,2215,2222,2203,2223,2215,2215,2219,0,4,11.691266581757269,0
2229,2230,2211,2191,2204,2238,2215,2215,2222,2203,2223,2215,2215,2219,2263,34,48,16.758224704248814,0
2230,2211,2191,2204,2238,2215,2215,2222,2203,2223,2215,2215,2219,2263,2294,64,72,25.503127726016743,0
2211,2191,2204,2238,2215,2215,2222,2203,2223,2215,2215,2219,2263,2294,2329,118,126,37.29011103432626,0
2191,2204,2238,2215,2215,2222,2203,2223,2215,2215,2219,2263,2294,2329,2309,118,86,41.93191760801924,0
2204,2238,2215,2215,2222,2203,2223,2215,2215,2219,2263,2294,2329,2309,2324,120,109,45.42634016682811,0
2238,2215,2215,2222,2203,2223,2215,2215,2219,2263,2294,2329,2309,2324,2353,115,138,51.5020110564349,0
2215,2215,2222,2203,2223,2215,2215,2219,2263,2294,2329,2309,2324,2353,2331,116,112,54.70440044979406,0
2215,2222,2203,2223,2215,2215,2219,2263,2294,2329,2309,2324,2353,2331,2326,111,63,55.39571927762753,0
2222,2203,2223,2215,2215,2219,2263,2294,2329,2309,2324,2353,2331,2326,2312,90,18,54.24134778491229,0
2203,2223,2215,2215,2219,2263,2294,2329,2309,2324,2353,2331,2326,2312,2333,130,4,53.93841285162533,0
2223,2215,2215,2219,2263,2294,2329,2309,2324,2353,2331,2326,2312,2333,2325,102,16,50.02684993366776,0
2215,2215,2219,2263,2294,2329,2309,2324,2353,2331,2326,2312,2333,2325,2324,109,0,46.85977054188481,0
2215,2219,2263,2294,2329,2309,2324,2353,2331,2326,2312,2333,2325,2324,2345,130,-8,42.17345136457295,0
2219,2263,2294,2329,2309,2324,2353,2331,2326,2312,2333,2325,2324,2345,2328,109,-3,33.881445969031205,0
2263,2294,2329,2309,2324,2353,2331,2326,2312,2333,2325,2324,2345,2328,2317,54,-9,21.296769260908587,0
2294,2329,2309,2324,2353,2331,2326,2312,2333,2325,2324,2345,2328,2317,2336,42,24,14.33012145630249,0
2329,2309,2324,2353,2331,2326,2312,2333,2325,2324,2345,2328,2317,2336,2333,4,0,11.399665826346881,0
2309,2324,2353,2331,2326,2312,2333,2325,2324,2345,2328,2317,2336,2333,2322,13,-3,11.5131394915714,0
2324,2353,2331,2326,2312,2333,2325,2324,2345,2328,2317,2336,2333,2322,2305,-19,-19,12.016655108639842,0
2353,2331,2326,2312,2333,2325,2324,2345,2328,2317,2336,2333,2322,2305,2315,-38,-30,12.42692928396116,0
2331,2326,2312,2333,2325,2324,2345,2328,2317,2336,2333,2322,2305,2315,2301,-30,-27,11.897578785298332,0
2326,2312,2333,2325,2324,2345,2328,2317,2336,2333,2322,2305,2315,2301,2318,-8,1,11.787806452108931,0
2312,2333,2325,2324,2345,2328,2317,2336,2333,2322,2305,2315,2301,2318,2278,-34,-58,16.422400497346242,0
2333,2325,2324,2345,2328,2317,2336,2333,2322,2305,2315,2301,2318,2278,2257,-76,-76,23.022349389855318,0
2325,2324,2345,2328,2317,2336,2333,2322,2305,2315,2301,2318,2278,2257,2255,-70,-67,27.275839649246887,0
2324,2345,2328,2317,2336,2333,2322,2305,2315,2301,2318,2278,2257,2255,2239,-85,-66,32.559542526328734,0
2345,2328,2317,2336,2333,2322,2305,2315,2301,2318,2278,2257,2255,2239,2276,-69,-39,32.901729582558566,0
2328,2317,2336,2333,2322,2305,2315,2301,2318,2278,2257,2255,2239,2276,2296,-32,-5,30.647302374877025,0
2317,2336,2333,2322,2305,2315,2301,2318,2278,2257,2255,2239,2276,2296,2308,-9,-10,29.68757957382819,0
2336,2333,2322,2305,2315,2301,2318,2278,2257,2255,2239,2276,2296,2308,2313,-23,35,29.51319317574043,0
2333,2322,2305,2315,2301,2318,2278,2257,2255,2239,2276,2296,2308,2313,2297,-36,40,27.459580685592623,0
2322,2305,2315,2301,2318,2278,2257,2255,2239,2276,2296,2308,2313,2297,2302,-20,47,25.421775442849516,0
2305,2315,2301,2318,2278,2257,2255,2239,2276,2296,2308,2313,2297,2302,2300,-5,61,24.179881444429512,2
2315,2301,2318,2278,2257,2255,2239,2276,2296,2308,2313,2297,2302,2300,2121,-194,-155,49.648478612858106,2
2301,2318,2278,2257,2255,2239,2276,2296,2308,2313,2297,2302,2300,2121,2128,-173,-168,61.79397412446652,2
2318,2278,2257,2255,2239,2276,2296,2308,2313,2297,2302,2300,2121,2128,2128,-190,-180,70.3357255291668,2
2278,2257,2255,2239,2276,2296,2308,2313,2297,2302,2300,2121,2128,2128,2130,-148,-183,74.80151513616998,2
2257,2255,2239,2276,2296,2308,2313,2297,2302,2300,2121,2128,2128,2130,2125,-132,-172,79.78781384456676,2
2255,2239,2276,2296,2308,2313,2297,2302,2300,2121,2128,2128,2130,2125,2123,-132,-179,84.13209568178796,2
2239,2276,2296,2308,2313,2297,2302,2300,2121,2128,2128,2130,2125,2123,2126,-113,-174,87.13771257257648,2
2276,2296,2308,2313,2297,2302,2300,2121,2128,2128,2130,2125,2123,2126,2124,-152,3,89.81160175346952,2
2296,2308,2313,2297,2302,2300,2121,2128,2128,2130,2125,2123,2126,2124,2124,-172,-4,89.98068575824375,2
2308,2313,2297,2302,2300,2121,2128,2128,2130,2125,2123,2126,2124,2124,2125,-183,-3,87.24224621024796,2
2313,2297,2302,2300,2121,2128,2128,2130,2125,2123,2126,2124,2124,2125,2131,-182,1,81.16637821401761,2
2297,2302,2300,2121,2128,2128,2130,2125,2123,2126,2124,2124,2125,2131,2134,-163,9,71.74578135930462,2
2302,2300,2121,2128,2128,2130,2125,2123,2126,2124,2124,2125,2131,2134,2136,-166,13,61.25458194718016,2
2300,2121,2128,2128,2130,2125,2123,2126,2124,2124,2125,2131,2134,2136,2135,-165,9,44.67928037959089,2
2121,2128,2128,2130,2125,2123,2126,2124,2124,2125,2131,2134,2136,2135,2132,11,8,4.673124783064886,0
2128,2128,2130,2125,2123,2126,2124,2124,2125,2131,2134,2136,2135,2132,2132,4,8,4.3237990350197935,0
2128,2130,2125,2123,2126,2124,2124,2125,2131,2134,2136,2135,2132,2132,2128,0,3,4.3237990350197935,0
2130,2125,2123,2126,2124,2124,2125,2131,2134,2136,2135,2132,2132,2128,2128,-2,-3,4.3237990350197935,0
2125,2123,2126,2124,2124,2125,2131,2134,2136,2135,2132,2132,2128,2128,2129,4,-5,4.312771730569565,0
2123,2126,2124,2124,2125,2131,2134,2136,2135,2132,2132,2128,2128,2129,2129,6,-7,4.182730937466346,0
2126,2124,2124,2125,2131,2134,2136,2135,2132,2132,2128,2128,2129,2129,2134,8,-1,4.0035698356056475,0
2124,2124,2125,2131,2134,2136,2135,2132,2132,2128,2128,2129,2129,2134,2136,12,4,4.155317877932646,0
2124,2125,2131,2134,2136,2135,2132,2132,2128,2128,2129,2129,2134,2136,2135,11,3,3.8950518060006045,0
2125,2131,2134,2136,2135,2132,2132,2128,2128,2129,2129,2134,2136,2135,2138,13,10,3.7199590371528606,0
2131,2134,2136,2135,2132,2132,2128,2128,2129,2129,2134,2136,2135,2138,2133,2,5,3.154739442867026,0
2134,2136,2135,2132,2132,2128,2128,2129,2129,2134,2136,2135,2138,2133,2133,-1,4,3.1213550171131037,0
2136,2135,2132,2132,2128,2128,2129,2129,2134,2136,2135,2138,2133,2133,2132,-4,3,3.1091263510296048,0
2135,2132,2132,2128,2128,2129,2129,2134,2136,2135,2138,2133,2133,2132,2130,-5,-4,3.034719725036203,0
2132,2132,2128,2128,2129,2129,2134,2136,2135,2138,2133,2133,2132,2130,2129,-3,-7,3.0441200151548995,0
2132,2128,2128,2129,2129,2134,2136,2135,2138,2133,2133,2132,2130,2129,2132,0,-3,3.0441200151548995,0
2128,2128,2129,2129,2134,2136,2135,2138,2133,2133,2132,2130,2129,2132,2136,8,-2,3.2263793654069586,0
2128,2129,2129,2134,2136,2135,2138,2133,2133,2132,2130,2129,2132,2136,2138,10,5,3.3423687066852112,0
2129,2129,2134,2136,2135,2138,2133,2133,2132,2130,2129,2132,2136,2138,2141,12,8,3.6774732526300613,0
2129,2134,2136,2135,2138,2133,2133,2132,2130,2129,2132,2136,2138,2141,2139,10,7,3.6774732526300613,0
2134,2136,2135,2138,2133,2133,2132,2130,2129,2132,2136,2138,2141,2139,2135,1,5,3.369329451445933,0
2136,2135,2138,2133,2133,2132,2130,2129,2132,2136,2138,2141,2139,2135,2136,0,7,3.3777986632604096,0
2135,2138,2133,2133,2132,2130,2129,2132,2136,2138,2141,2139,2135,2136,2132,-3,0,3.439269025326665,0
2138,2133,2133,2132,2130,2129,2132,2136,2138,2141,2139,2135,2136,2132,2132,-6,-4,3.5010202594590702,0
2133,2133,2132,2130,2129,2132,2136,2138,2141,2139,2135,2136,2132,2132,2132,-1,-6,3.401680257083045,0
2133,2132,2130,2129,2132,2136,2138,2141,2139,2135,2136,2132,2132,2132,2133,0,-8,3.401680257083045,0
2132,2130,2129,2132,2136,2138,2141,2139,2135,2136,2132,2132,2132,2133,2136,4,-3,3.4267852490135917,0
2130,2129,2132,2136,2138,2141,2139,2135,2136,2132,2132,2132,2133,2136,2137,7,2,3.4406533155921477,0
2129,2132,2136,2138,2141,2139,2135,2136,2132,2132,2132,2133,2136,2137,2141,12,5,3.5750457872525745,0
2132,2136,2138,2141,2139,2135,2136,2132,2132,2132,2133,2136,2137,2141,2139,7,7,3.2396354880199247,0
2136,2138,2141,2139,2135,2136,2132,2132,2132,2133,2136,2137,2141,2139,2138,2,6,3.0860669992418384,0
2138,2141,2139,2135,2136,2132,2132,2132,2133,2136,2137,2141,2139,2138,2133,-5,1,3.204163957519444,0
2141,2139,2135,2136,2132,2132,2132,2133,2136,2137,2141,2139,2138,2133,2131,-10,-2,3.415650255319866,0
2139,2135,2136,2132,2132,2132,2133,2136,2137,2141,2139,2138,2133,2131,2128,-11,-8,3.60951124510943,0
2135,2136,2132,2132,2132,2133,2136,2137,2141,2139,2138,2133,2131,2128,2126,-9,-11,4.0614330100640705,0
2136,2132,2132,2132,2133,2136,2137,2141,2139,2138,2133,2131,2128,2126,2099,-37,-42,9.869626325729046,0
2132,2132,2132,2133,2136,2137,2141,2139,2138,2133,2131,2128,2126,2099,2090,-42,-49,14.461113702748124,0
2132,2132,2133,2136,2137,2141,2139,2138,2133,2131,2128,2126,2099,2090,2095,-37,-43,16.784346448828018,0
2132,2133,2136,2137,2141,2139,2138,2133,2131,2128,2126,2099,2090,2095,2101,-31,-32,17.866435677255936,0
2133,2136,2137,2141,2139,2138,2133,2131,2128,2126,2099,2090,2095,2101,2102,-31,-29,18.564430916085072,0
2136,2137,2141,2139,2138,2133,2131,2128,2126,2099,2090,2095,2101,2102,2097,-39,-31,19.34228035997332,0
2137,2141,2139,2138,2133,2131,2128,2126,2099,2090,2095,2101,2102,2097,2092,-45,-34,19.99214131316889,0
2141,2139,2138,2133,2131,2128,2126,2099,2090,2095,2101,2102,2097,2092,2087,-54,-12,20.50946355315261,0
2139,2138,2133,2131,2128,2126,2099,2090,2095,2101,2102,2097,2092,2087,2084,-55,-6,20.28323257790838,0
2138,2133,2131,2128,2126,2099,2090,2095,2101,2102,2097,2092,2087,2084,2082,-56,-13,19.68562443824959,0
2133,2131,2128,2126,2099,2090,2095,2101,2102,2097,2092,2087,2084,2082,2086,-47,-15,18.099723754798028,0
2131,2128,2126,2099,2090,2095,2101,2102,2097,2092,2087,2084,2082,2086,2091,-40,-11,16.136914203155445,0
2128,2126,2099,2090,2095,2101,2102,2097,2092,2087,2084,2082,2086,2091,2098,-30,1,13.565713082199972,0
2126,2099,2090,2095,2101,2102,2097,2092,2087,2084,2082,2086,2091,2098,2101,-25,9,10.669047353375625,0
2099,2090,2095,2101,2102,2097,2092,2087,2084,2082,2086,2091,2098,2101,2101,2,14,6.79775873428322,0
2090,2095,2101,2102,2097,2092,2087,2084,2082,2086,2091,2098,2101,2101,2098,8,14,6.747133430117528,0
2095,2101,2102,2097,2092,2087,2084,2082,2086,2091,2098,2101,2101,2098,2092,-3,10,6.689010176614858,0
2101,2102,2097,2092,2087,2084,2082,2086,2091,2098,2101,2101,2098,2092,2084,-17,-2,7.136092034426793,0
2102,2097,2092,2087,2084,2082,2086,2091,2098,2101,2101,2098,2092,2084,2082,-20,-9,7.311439178242739,0
2097,2092,2087,2084,2082,2086,2091,2098,2101,2101,2098,2092,2084,2082,2081,-16,-17,7.228910212275627,0
2092,2087,2084,2082,2086,2091,2098,2101,2101,2098,2092,2084,2082,2081,2083,-9,-18,7.219682092987857,0
2087,2084,2082,2086,2091,2098,2101,2101,2098,2092,2084,2082,2081,2083,2092,5,-9,7.219682092987857,0
2084,2082,2086,2091,2098,2101,2101,2098,2092,2084,2082,2081,2083,2092,2096,12,-2,7.372406727275765,0
2082,2086,2091,2098,2101,2101,2098,2092,2084,2082,2081,2083,2092,2096,2100,18,8,7.586328555525457,0
2086,2091,2098,2101,2101,2098,2092,2084,2082,2081,2083,2092,2096,2100,2102,16,18,7.623897266084422,0
2091,2098,2101,2101,2098,2092,2084,2082,2081,2083,2092,2096,2100,2102,2099,8,17,7.575021609272965,0
2098,2101,2101,2098,2092,2084,2082,2081,2083,2092,2096,2100,2102,2099,2093,-5,12,7.5485728704803785,0
2101,2101,2098,2092,2084,2082,2081,2083,2092,2096,2100,2102,2099,2093,2085,-16,2,7.734893110352038,0
2101,2098,2092,2084,2082,2081,2083,2092,2096,2100,2102,2099,2093,2085,2081,-20,-11,7.9053929753832035,0
2098,2092,2084,2082,2081,2083,2092,2096,2100,2102,2099,2093,2085,2081,2080,-18,-16,7.918032463638811,0
2092,2084,2082,2081,2083,2092,2096,2100,2102,2099,2093,2085,2081,2080,2085,-7,-15,7.671840904055744,0
2084,2082,2081,2083,2092,2096,2100,2102,2099,2093,2085,2081,2080,2085,2089,5,-13,7.627019638851638,0
2082,2081,2083,2092,2096,2100,2102,2099,2093,2085,2081,2080,2085,2089,2097,15,-2,7.779704976656218,0
2081,2083,2092,2096,2100,2102,2099,2093,2085,2081,2080,2085,2089,2097,2100,19,7,7.899969861304776,0
2083,2092,2096,2100,2102,2099,2093,2085,2081,2080,2085,2089,2097,2100,2099,16,14,7.657551517168868,0
2092,2096,2100,2102,2099,2093,2085,2081,2080,2085,2089,2097,2100,2099,2095,3,14,7.259148579223193,0
2096,2100,2102,2099,2093,2085,2081,2080,2085,2089,2097,2100,2099,2095,2092,-4,12,7.259148579223193,0
2100,2102,2099,2093,2085,2081,2080,2085,2089,2097,2100,2099,2095,2092,2088,-12,3,7.306226959310282,0
2102,2099,2093,2085,2081,2080,2085,2089,2097,2100,2099,2095,2092,2088,2081,-21,-8,7.525828541635482,0
2099,2093,2085,2081,2080,2085,2089,2097,2100,2099,2095,2092,2088,2081,2082,-17,-15,7.215723571941116,0
2093,2085,2081,2080,2085,2089,2097,2100,2099,2095,2092,2088,2081,2082,2083,-10,-17,6.924765768773768,0
2085,2081,2080,2085,2089,2097,2100,2099,2095,2092,2088,2081,2082,2083,2091,6,-8,6.854265269228525,0
2081,2080,2085,2089,2097,2100,2099,2095,2092,2088,2081,2082,2083,2091,2093,12,-2,6.870918702002215,0
2080,2085,2089,2097,2100,2099,2095,2092,2088,2081,2082,2083,2091,2093,2100,20,8,7.027158200933886,0
2085,2089,2097,2100,2099,2095,2092,2088,2081,2082,2083,2091,2093,2100,2101,16,13,6.912376753400554,0
2089,2097,2100,2099,2095,2092,2088,2081,2082,2083,2091,2093,2100,2101,2099,10,18,6.883382335810817,0
2097,2100,2099,2095,2092,2088,2081,2082,2083,2091,2093,2100,2101,2099,2091,-6,9,6.826419266350405,0
2100,2099,2095,2092,2088,2081,2082,2083,2091,2093,2100,2101,2099,2091,2088,-12,5,6.826419266350405,0
2099,2095,2092,2088,2081,2082,2083,2091,2093,2100,2101,2099,2091,2088,2079,-20,-12,7.252585745787498,0
2095,2092,2088,2081,2082,2083,2091,2093,2100,2101,2099,2091,2088,2079,2080,-15,-13,7.376281163941883,0
2092,2088,2081,2082,2083,2091,2093,2100,2101,2099,2091,2088,2079,2080,2084,-8,-16,7.340688951707073,0
2088,2081,2082,2083,2091,2093,2100,2101,2099,2091,2088,2079,2080,2084,2087,-1,-14,7.2984016515033385,0
2081,2082,2083,2091,2093,2100,2101,2099,2091,2088,2079,2080,2084,2087,2093,12,-6,7.389181280764467,0
2082,2083,2091,2093,2100,2101,2099,2091,2088,2079,2080,2084,2087,2093,2100,18,9,7.582561446848821,0
2083,2091,2093,2100,2101,2099,2091,2088,2079,2080,2084,2087,2093,2100,2099,16,11,7.5611790463808335,0
2091,2093,2100,2101,2099,2091,2088,2079,2080,2084,2087,2093,2100,2099,2098,7,19,7.389181280764467,0
2093,2100,2101,2099,2091,2088,2079,2080,2084,2087,2093,2100,2099,2098,2092,-1,12,7.382089006185044,0
2100,2101,2099,2091,2088,2079,2080,2084,2087,2093,2100,2099,2098,2092,2085,-15,1,7.610769312218675,0
2101,2099,2091,2088,2079,2080,2084,2087,2093,2100,2099,2098,2092,2085,2082,-19,-5,7.633260552782583,0
2099,2091,2088,2079,2080,2084,2087,2093,2100,2099,2098,2092,2085,2082,2080,-19,-13,7.501111028818776,0
2091,2088,2079,2080,2084,2087,2093,2100,2099,2098,2092,2085,2082,2080,2083,-8,-17,7.1260755245052225,0
2088,2079,2080,2084,2087,2093,2100,2099,2098,2092,2085,2082,2080,2083,2089,1,-10,7.085867893880312,0
2079,2080,2084,2087,2093,2100,2099,2098,2092,2085,2082,2080,2083,2089,2096,17,-2,7.385958363840197,0
2080,2084,2087,2093,2100,2099,2098,2092,2085,2082,2080,2083,2089,2096,2099,19,7,7.360124222554166,0
2084,2087,2093,2100,2099,2098,2092,2085,2082,2080,2083,2089,2096,2099,2102,18,17,7.4590948001815365,0
2087,2093,2100,2099,2098,2092,2085,2082,2080,2083,2089,2096,2099,2102,2100,13,18,7.4896754332372835,0
2093,2100,2099,2098,2092,2085,2082,2080,2083,2089,2096,2099,2102,2100,2091,-2,11,7.356241276241945,0
2100,2099,2098,2092,2085,2082,2080,2083,2089,2096,2099,2102,2100,2091,2086,-14,3,7.5485728704803785,0
2099,2098,2092,2085,2082,2080,2083,2089,2096,2099,2102,2100,2091,2086,2082,-17,-7,7.638873015856524,0
2098,2092,2085,2082,2080,2083,2089,2096,2099,2102,2100,2091,2086,2082,2082,-16,-14,7.617648681093886,0
2092,2085,2082,2080,2083,2089,2096,2099,2102,2100,2091,2086,2082,2082,2080,-12,-19,7.651330416526079,0
2085,2082,2080,2083,2089,2096,2099,2102,2100,2091,2086,2082,2082,2080,2087,2,-15,7.601378321130476,0
2082,2080,2083,2089,2096,2099,2102,2100,2091,2086,2082,2082,2080,2087,2095,13,-5,7.73181430072867,0
2080,2083,2089,2096,2099,2102,2100,2091,2086,2082,2082,2080,2087,2095,2098,18,7,7.810249675906654,0
2083,2089,2096,2099,2102,2100,2091,2086,2082,2082,2080,2087,2095,2098,2100,17,14,7.687342720032592,0
2089,2096,2099,2102,2100,2091,2086,2082,2082,2080,2087,2095,2098,2100,2099,10,17,7.557399401532627,0
2096,2099,2102,2100,2091,2086,2082,2082,2080,2087,2095,2098,2100,2099,2093,-3,11,7.4992063072098,0
2099,2102,2100,2091,2086,2082,2082,2080,2087,2095,2098,2100,2099,2093,2087,-12,7,7.573135476959392,0
2102,2100,2091,2086,2082,2082,2080,2087,2095,2098,2100,2099,2093,2087,2082,-20,-5,7.73181430072867,0
2100,2091,2086,2082,2082,2080,2087,2095,2098,2100,2099,2093,2087,2082,2080,-20,-15,7.567474259399015,0
2091,2086,2082,2082,2080,2087,2095,2098,2100,2099,2093,2087,2082,2080,2081,-10,-17,7.262427771954578,0
2086,2082,2082,2080,2087,2095,2098,2100,2099,2093,2087,2082,2080,2081,2087,1,-13,7.22561580832553,0
2082,2082,2080,2087,2095,2098,2100,2099,2093,2087,2082,2080,2081,2087,2095,13,-4,7.424541031189034,0
2082,2080,2087,2095,2098,2100,2099,2093,2087,2082,2080,2081,2087,2095,2098,16,5,7.566844973774925,0
2080,2087,2095,2098,2100,2099,2093,2087,2082,2080,2081,2087,2095,2098,2101,21,14,7.790714864198156,0
2087,2095,2098,2100,2099,2093,2087,2082,2080,2081,2087,2095,2098,2101,2099,12,17,7.434155410446211,0
2095,2098,2100,2099,2093,2087,2082,2080,2081,2087,2095,2098,2101,2099,2093,-2,13,7.2984016515033385,0
2098,2100,2099,2093,2087,2082,2080,2081,2087,2095,2098,2101,2099,2093,2087,-11,6,7.396910551999782,0
2100,2099,2093,2087,2082,2080,2081,2087,2095,2098,2101,2099,2093,2087,2080,-20,-7,7.8029298526716415,0
2099,2093,2087,2082,2080,2081,2087,2095,2098,2101,2099,2093,2087,2080,2080,-19,-15,7.827302643099133,0
2093,2087,2082,2080,2081,2087,2095,2098,2101,2099,2093,2087,2080,2080,2081,-12,-17,7.638873015856524,0
2087,2082,2080,2081,2087,2095,2098,2101,2099,2093,2087,2080,2080,2081,2087,0,-14,7.529624034122693,0
2082,2080,2081,2087,2095,2098,2101,2099,2093,2087,2080,2080,2081,2087,2095,13,-4,7.744122195021755,0
2080,2081,2087,2095,2098,2101,2099,2093,2087,2080,2080,2081,2087,2095,2099,19,6,7.980929651064348,0
2081,2087,2095,2098,2101,2099,2093,2087,2080,2080,2081,2087,2095,2099,2101,20,14,8.030892733391356,0
2087,2095,2098,2101,2099,2093,2087,2080,2080,2081,2087,2095,2099,2101,2100,13,20,7.848566748139434,0
2095,2098,2101,2099,2093,2087,2080,2080,2081,2087,2095,2099,2101,2100,2093,-2,13,7.716401826165946,0
2098,2101,2099,2093,2087,2080,2080,2081,2087,2095,2099,2101,2100,2093,2085,-13,4,7.9234432149762,0
2101,2099,2093,2087,2080,2080,2081,2087,2095,2099,2101,2100,2093,2085,2082,-19,-5,8.122866020128141,0
2099,2093,2087,2080,2080,2081,2087,2095,2099,2101,2100,2093,2085,2082,2079,-20,-16,8.148619514985345,0
2093,2087,2080,2080,2081,2087,2095,2099,2101,2100,2093,2085,2082,2079,2080,-13,-19,8.025554423809226,0
2087,2080,2080,2081,2087,2095,2099,2101,2100,2093,2085,2082,2079,2080,2086,-1,-15,7.925245977856069,0
2080,2080,2081,2087,2095,2099,2101,2100,2093,2085,2082,2079,2080,2086,2090,10,-10,7.945049372018372,0
2080,2081,2087,2095,2099,2101,2100,2093,2085,2082,2079,2080,2086,2090,2099,19,6,8.114067736844156,0
2081,2087,2095,2099,2101,2100,2093,2085,2082,2079,2080,2086,2090,2099,2101,20,16,8.236388482708621,0
2087,2095,2099,2101,2100,2093,2085,2082,2079,2080,2086,2090,2099,2101,2100,13,18,8.125796664239846,0
2095,2099,2101,2100,2093,2085,2082,2079,2080,2086,2090,2099,2101,2100,2092,-3,13,8.01664934163062,0
2099,2101,2100,2093,2085,2082,2079,2080,2086,2090,2099,2101,2100,2092,2088,-11,8,8.04155872120988,0
2101,2100,2093,2085,2082,2079,2080,2086,2090,2099,2101,2100,2092,2088,2080,-21,-6,8.296298658351892,0
2100,2093,2085,2082,2079,2080,2086,2090,2099,2101,2100,2092,2088,2080,2079,-21,-11,8.23291882511618,0
2093,2085,2082,2079,2080,2086,2090,2099,2101,2100,2092,2088,2080,2079,2082,-11,-17,7.805370556470047,0
2085,2082,2079,2080,2086,2090,2099,2101,2100,2092,2088,2080,2079,2082,2086,1,-15,7.676184568117779,0
2082,2079,2080,2086,2090,2099,2101,2100,2092,2088,2080,2079,2082,2086,2091,9,-9,7.705903735510351,0
2079,2080,2086,2090,2099,2101,2100,2092,2088,2080,2079,2082,2086,2091,2098,19,6,7.968389931174182,0
2080,2086,2090,2099,2101,2100,2092,2088,2080,2079,2082,2086,2091,2098,2098,18,10,7.819389819088006,0
2086,2090,2099,2101,2100,2092,2088,2080,2079,2082,2086,2091,2098,2098,2098,12,18,7.551726387295254,0
2090,2099,2101,2100,2092,2088,2080,2079,2082,2086,2091,2098,2098,2098,2093,3,14,7.42261666093825,0
2099,2101,2100,2092,2088,2080,2079,2082,2086,2091,2098,2098,2098,2093,2089,-10,7,7.443117626371358,0
2101,2100,2092,2088,2080,2079,2082,2086,2091,2098,2098,2098,2093,2089,2082,-19,-4,7.529624034122693,0
2100,2092,2088,2080,2079,2082,2086,2091,2098,2098,2098,2093,2089,2082,2078,-22,-13,7.573135476959392,0
2092,2088,2080,2079,2082,2086,2091,2098,2098,2098,2093,2089,2082,2078,2080,-12,-18,7.238784428341543,0
2088,2080,2079,2082,2086,2091,2098,2098,2098,2093,2089,2082,2078,2080,2085,-3,-13,7.160074487508259,0
2080,2079,2082,2086,2091,2098,2098,2098,2093,2089,2082,2078,2080,2085,2092,12,-6,7.268326590665243,0
2079,2082,2086,2091,2098,2098,2098,2093,2089,2082,2078,2080,2085,2092,2098,19,5,7.443117626371358,0
2082,2086,2091,2098,2098,2098,2093,2089,2082,2078,2080,2085,2092,2098,2101,19,12,7.582561446848821,0
2086,2091,2098,2098,2098,2093,2089,2082,2078,2080,2085,2092,2098,2101,2097,11,15,7.430311151595457,0
2091,2098,2098,2098,2093,2089,2082,2078,2080,2085,2092,2098,2101,2097,2093,2,15,7.30818197703942,0
2098,2098,2098,2093,2089,2082,2078,2080,2085,2092,2098,2101,2097,2093,2089,-9,9,7.3367957194248925,0
2098,2098,2093,2089,2082,2078,2080,2085,2092,2098,2101,2097,2093,2089,2083,-15,-2,7.394978991566797,0
2098,2093,2089,2082,2078,2080,2085,2092,2098,2101,2097,2093,2089,2083,2078,-20,-14,7.722570507162446,0
2093,2089,2082,2078,2080,2085,2092,2098,2101,2097,2093,2089,2083,2078,2079,-14,-19,7.710845793889465,0
2089,2082,2078,2080,2085,2092,2098,2101,2097,2093,2089,2083,2078,2079,2086,-3,-15,7.5844452350722085,0
2082,2078,2080,2085,2092,2098,2101,2097,2093,2089,2083,2078,2079,2086,2092,10,-5,7.670599405398201,0
2078,2080,2085,2092,2098,2101,2097,2093,2089,2083,2078,2079,2086,2092,2098,20,5,7.953435915196831,0
2080,2085,2092,2098,2101,2097,2093,2089,2083,2078,2079,2086,2092,2098,2100,20,11,7.887301427581161,0
2085,2092,2098,2101,2097,2093,2089,2083,2078,2079,2086,2092,2098,2100,2097,12,14,7.551726387295254,0
2092,2098,2101,2097,2093,2089,2083,2078,2079,2086,2092,2098,2100,2097,2094,2,16,7.3795083072751435,0
2098,2101,2097,2093,2089,2083,2078,2079,2086,2092,2098,2100,2097,2094,2088,-10,9,7.443757371752777,0
2101,2097,2093,2089,2083,2078,2079,2086,2092,2098,2100,2097,2094,2088,2082,-19,-4,7.595738153414591,0
2097,2093,2089,2083,2078,2079,2086,2092,2098,2100,2097,2094,2088,2082,2079,-18,-13,7.54036755451237,0
2093,2089,2083,2078,2079,2086,2092,2098,2100,2097,2094,2088,2082,2079,2078,-15,-20,7.69477249888025,0
2089,2083,2078,2079,2086,2092,2098,2100,2097,2094,2088,2082,2079,2078,2084,-5,-16,7.605136109110425,0
2083,2078,2079,2086,2092,2098,2100,2097,2094,2088,2082,2079,2078,2084,2090,7,-7,7.627019638851638,0
2078,2079,2086,2092,2098,2100,2097,2094,2088,2082,2079,2078,2084,2090,2098,20,4,8.010707120562364,0
2079,2086,2092,2098,2100,2097,2094,2088,2082,2079,2078,2084,2090,2098,2100,21,12,8.023774198028779,0
2086,2092,2098,2100,2097,2094,2088,2082,2079,2078,2084,2090,2098,2100,2099,13,17,7.782764841072135,0
2092,2098,2100,2097,2094,2088,2082,2079,2078,2084,2090,2098,2100,2099,2094,2,15,7.689200837786039,0
2098,2100,2097,2094,2088,2082,2079,2078,2084,2090,2098,2100,2099,2094,2090,-8,12,7.697866123617821,0
2100,2097,2094,2088,2082,2079,2078,2084,2090,2098,2100,2099,2094,2090,2082,-18,-2,7.825477316949761,0
